bagnistéj	bagnistej
bardziéj	bardziej
biédą	biedą
biédę	biedę
bliżéj	bliżej
bohatéra	bohatera
całéj	całej
ciérpiał	cierpiał
ciszéj	ciszej
cudzéj	cudzej
cztéry	cztery
daléj	dalej
długiéj	długiej
dłużéj	dłużej
dobréj	dobrej
dobrodziéj	dobrodziej
drobnéj	drobnej
drugiéj	drugiej
drzémiący	drzemiący
gęściéj	gęściej
gęstéj	gęstej
głuchéj	głuchej
gorzéj	gorzej
idée	idee
jakiéj	jakiej
jednéj	jednej
jéj	jej
karéta	kareta
każdéj	każdej
każdém	każdym
kobiéce	kobiece
kobiécie	kobiecie
kobiéta	kobieta
kobiétą	kobietą
książęcéj	książęcej
lubéj	lubej
méj	mej
najdaléj	najdalej
namiętnéj	namiętnej
narzeczonéj	narzeczonej
nié	nie
niéj	niej
niém	niem
niewidzialnéj	niewidzialnej
opowiém	opowiem
pajęczéj	pajęczej
pierwéj	pierwej
podléjszy	podlejszy
powié	powie
prościéj	prościej
raczéj	raczej
rodzinnéj	rodzinnej
samotnéj	samotnej
srébrne	srebrne
stér	ster
stérczą	sterczą
swéj	swej
świécą	świecą
świéce	świece
świécę	świecę
świécy	świecy
szczérze	szczerze
szerzéj	szerzej
takiéj	takiej
téj	tej
tém	tem
twéj	twej
twojéj	twojej
umié	umie
uśmiécha	uśmiecha
uśmiéchał	uśmiechał
widziéć	widzieć
więcéj	więcej
wiélkiej	wielkiej
wiérzchu	wierzchu
wschodniéj	wschodniej
zawiłéj	zawiłej
zéjdzie	zejdzie
ziemskiéj	ziemskiej
żołnierskiéj	żołnierskiej
żołniérz	żołnierz
kreacyi	kreacji
lekcya	lekcja
policyi	policji
protestacyi	protestacji
rewolucyi	rewolucji
stancyi	stancji
itd.	i tak dalej
np.	na przykład
Hispanlola	Hispaniola
drugiemi	drugimi
sie	się
pięknemi	pięknymi
któremi	którymi
drogiemi	drogimi
swemi	swymi
twemi	twymi
eks-ministra	eksministra
eks-gubernator	eksgubernator
eks-gubernatorem	eksgubernatorem
eks-bankiera	eksbankiera
eks-bednarz	eksbednarz
eks-dzierżawca	eksdzierżawca
eks-jakobina	eksjakobina
eks-jeńca	eksjeńca
eks-koteczki	ekskoteczki
eks-kwatermistrz	ekskwatermistrz
eks-lenno	ekslenno
eks-mera	eksmera
eks-poborca	ekspoborca
eks-skarbu	eksskarbu
artyleryji	artylerii
dyskusyji	dyskusji
vis-a-vis	vis-à-vis
tryumf	triumf
tryumfach	triumfach
tryumfalną	triumfalną
tryumfalne	triumfalne
tryumfalnego	triumfalnego
tryumfalnej	triumfalnej
tryumfalnie	triumfalnie
tryumfalny	triumfalny
tryumfalnym	triumfalnym
tryumfator	triumfator
tryumfatorów	triumfatorów
tryumfem	triumfem
tryumfie	triumfie
tryumfom	triumfom
tryumfów	triumfów
tryumfować	triumfować
tryumfował	triumfował
tryumfowała	triumfowała
tryumfowało	triumfowało
tryumfowania	triumfowania
tryumfowi	triumfowi
tryumfu	triumfu
tryumfującą	triumfującą
tryumfujące	triumfujące
tryumfującego	triumfującego
tryumfującej	triumfującej
tryumfująco	triumfująco
tryumfujący	triumfujący
tryumfującym	triumfującym
tryumfuje	triumfuje
tryumfy	triumfy
ztąd	stąd
hmmmm	hm
hmm	hm
heeej	hej
yyy	yy
yyym	yym
yyyy	yy
yyyyy	yy
yyyyyy	yy
youtube’a	youtube'a
fan-ta-stycz-nie	fantastycznie
facebook’u	facebooku
fast-food	fast food
fastfooda	fast fooda
fastfoodami	fast foodami
fastfoodów	fast foodów
fastfoody	fast foody
eliksir-mlodosci	eliksir młodości
duuuuża	duża
100-lecia	stulecia
aaa	aa
aaaa	aa
aaaaaaaaaaaaaaaaaaaaaaaaaaaaaaa	aa
baaaardzo	bardzo
cooo	co
developer	deweloper
developera	dewelopera
developerach	deweloperach
developerami	deweloperami
developerce	deweloperce
developerek	deweloperek
developerem	deweloperem
developerka	deweloperka
developerką	deweloperką
developerkach	deweloperkach
developerkami	deweloperkami
developerkę	deweloperkę
developerki	deweloperki
developerko	deweloperko
developerkom	deweloperkom
developerom	deweloperom
developerów	deweloperów
developerowi	deweloperowi
developerscy	deweloperscy
developerska	deweloperska
developerską	deweloperską
developerskich	deweloperskich
developerskie	deweloperskie
developerskiego	deweloperskiego
developerskiej	deweloperskiej
developerskiemu	deweloperskiemu
developerskim	deweloperskim
developerskimi	deweloperskimi
developersko	dewelopersko
developerskość	deweloperskość
developerskości	deweloperskości
developerskością	deweloperskością
developerskościach	deweloperskościach
developerskościami	deweloperskościami
developerskościom	deweloperskościom
developersku	dewelopersku
developery	dewelopery
developerze	deweloperze
developerzy	deweloperzy
niedeveloperscy	niedeweloperscy
niedeveloperska	niedeweloperska
niedeveloperską	niedeweloperską
niedeveloperski	niedeweloperski
niedeveloperskich	niedeweloperskich
niedeveloperskie	niedeweloperskie
niedeveloperskiego	niedeweloperskiego
niedeveloperskiej	niedeweloperskiej
niedeveloperskiemu	niedeweloperskiemu
niedeveloperskim	niedeweloperskim
niedeveloperskimi	niedeweloperskimi
niedevelopersko	niedewelopersko
hardcorowa	hardcore'owa
hardcorową	hardcore'ową
hardcorowe	hardcore'owe
hardcorowego	hardcore'owego
hardcorowej	hardcore'owej
hardcorowemu	hardcore'owemu
hardcorowi	hardcore'owi
hardcorowo	hardcore'owo
hardcorowy	hardcore'owy
hardcorowych	hardcore'owych
hardcorowym	hardcore'owym
hardcorowymi	hardcore'owymi
niehardcorowa	niehardcore'owa
niehardcorową	niehardcore'ową
niehardcorowe	niehardcore'owe
niehardcorowego	niehardcore'owego
niehardcorowej	niehardcore'owej
niehardcorowemu	niehardcore'owemu
niehardcorowi	niehardcore'owi
niehardcorowo	niehardcore'owo
niehardcorowy	niehardcore'owy
niehardcorowych	niehardcore'owych
niehardcorowym	niehardcore'owym
niehardcorowymi	niehardcore'owymi
kredytowo-lizingowa	kredytowo-leasingowa
kredytowo-lizingową	kredytowo-leasingową
kredytowo-lizingowe	kredytowo-leasingowe
kredytowo-lizingowego	kredytowo-leasingowego
kredytowo-lizingowej	kredytowo-leasingowej
kredytowo-lizingowemu	kredytowo-leasingowemu
kredytowo-lizingowi	kredytowo-leasingowi
kredytowo-lizingowy	kredytowo-leasingowy
kredytowo-lizingowych	kredytowo-leasingowych
kredytowo-lizingowym	kredytowo-leasingowym
kredytowo-lizingowymi	kredytowo-leasingowymi
lizing	leasing
lizingach	leasingach
lizingami	leasingami
lizingi	leasingi
lizingiem	leasingiem
lizingobiorca	leasingobiorca
lizingobiorcą	leasingobiorcą
lizingobiorcach	leasingobiorcach
lizingobiorcami	leasingobiorcami
lizingobiorce	leasingobiorce
lizingobiorcę	leasingobiorcę
lizingobiorco	leasingobiorco
lizingobiorcom	leasingobiorcom
lizingobiorców	leasingobiorców
lizingobiorcy	leasingobiorcy
lizingodawca	leasingodawca
lizingodawcą	leasingodawcą
lizingodawcach	leasingodawcach
lizingodawcami	leasingodawcami
lizingodawce	leasingodawce
lizingodawcę	leasingodawcę
lizingodawco	leasingodawco
lizingodawcom	leasingodawcom
lizingodawców	leasingodawców
lizingodawcy	leasingodawcy
lizingom	leasingom
lizingów	leasingów
lizingować	leasingować
lizingował	leasingował
lizingowała	leasingowała
lizingowałaby	leasingowałaby
lizingowałabym	leasingowałabym
lizingowałabyś	leasingowałabyś
lizingowałam	leasingowałam
lizingowałaś	leasingowałaś
lizingowałby	leasingowałby
lizingowałbym	leasingowałbym
lizingowałbyś	leasingowałbyś
lizingowałem	leasingowałem
lizingowałeś	leasingowałeś
lizingowali	leasingowali
lizingowaliby	leasingowaliby
lizingowalibyście	leasingowalibyście
lizingowalibyśmy	leasingowalibyśmy
lizingowaliście	leasingowaliście
lizingowaliśmy	leasingowaliśmy
lizingowało	leasingowało
lizingowałoby	leasingowałoby
lizingowały	leasingowały
lizingowałyby	leasingowałyby
lizingowałybyście	leasingowałybyście
lizingowałybyśmy	leasingowałybyśmy
lizingowałyście	leasingowałyście
lizingowałyśmy	leasingowałyśmy
lizingowań	leasingowań
lizingowana	leasingowana
lizingowaną	leasingowaną
lizingowane	leasingowane
lizingowanego	leasingowanego
lizingowanej	leasingowanej
lizingowanemu	leasingowanemu
lizingowani	leasingowani
lizingowania	leasingowania
lizingowaniach	leasingowaniach
lizingowaniami	leasingowaniami
lizingowanie	leasingowanie
lizingowaniem	leasingowaniem
lizingowaniom	leasingowaniom
lizingowaniu	leasingowaniu
lizingowano	leasingowano
lizingowany	leasingowany
lizingowanych	leasingowanych
lizingowanym	leasingowanym
lizingowanymi	leasingowanymi
lizingowi	leasingowi
lizingu	leasingu
lizinguj	leasinguj
lizingują	leasingują
lizingując	leasingując
lizingująca	leasingująca
lizingującą	leasingującą
lizingujące	leasingujące
lizingującego	leasingującego
lizingującej	leasingującej
lizingującemu	leasingującemu
lizingujący	leasingujący
lizingujących	leasingujących
lizingującym	leasingującym
lizingującymi	leasingującymi
lizingujcie	leasingujcie
lizingujcież	leasingujcież
lizinguje	leasinguje
lizinguję	leasinguję
lizingujecie	leasingujecie
lizingujemy	leasingujemy
lizingujesz	leasingujesz
lizingujmy	leasingujmy
lizingujmyż	leasingujmyż
lizingujże	leasingujże
nielizingowań	nieleasingowań
nielizingowana	nieleasingowana
nielizingowaną	nieleasingowaną
nielizingowane	nieleasingowane
nielizingowanego	nieleasingowanego
nielizingowanej	nieleasingowanej
nielizingowanemu	nieleasingowanemu
nielizingowani	nieleasingowani
nielizingowania	nieleasingowania
nielizingowaniach	nieleasingowaniach
nielizingowaniami	nieleasingowaniami
nielizingowanie	nieleasingowanie
nielizingowaniem	nieleasingowaniem
nielizingowaniom	nieleasingowaniom
nielizingowaniu	nieleasingowaniu
nielizingowany	nieleasingowany
nielizingowanych	nieleasingowanych
nielizingowanym	nieleasingowanym
nielizingowanymi	nieleasingowanymi
nielizingująca	nieleasingująca
nielizingującą	nieleasingującą
nielizingujące	nieleasingujące
nielizingującego	nieleasingującego
nielizingującej	nieleasingującej
nielizingującemu	nieleasingującemu
nielizingujący	nieleasingujący
nielizingujących	nieleasingujących
nielizingującym	nieleasingującym
nielizingującymi	nieleasingującymi
mejl	mail
mejla	maila
mejlach	mailach
mejlami	mailami
mejle	maile
mejlem	mailem
mejli	maili
mejling	mailing
mejlingach	mailingach
mejlingami	mailingami
mejlingi	mailingi
mejlingiem	mailingiem
mejlingom	mailingom
mejlingów	mailingów
mejlingowa	mailingowa
mejlingową	mailingową
mejlingowe	mailingowe
mejlingowego	mailingowego
mejlingowej	mailingowej
mejlingowemu	mailingowemu
mejlingowi	mailingowi
mejlingowy	mailingowy
mejlingowych	mailingowych
mejlingowym	mailingowym
mejlingowymi	mailingowymi
mejlingu	mailingu
mejlom	mailom
mejlów	mailów
mejlować	mailować
mejlował	mailował
mejlowała	mailowała
mejlowałaby	mailowałaby
mejlowałabym	mailowałabym
mejlowałabyś	mailowałabyś
mejlowałam	mailowałam
mejlowałaś	mailowałaś
mejlowałby	mailowałby
mejlowałbym	mailowałbym
mejlowałbyś	mailowałbyś
mejlowałem	mailowałem
mejlowałeś	mailowałeś
mejlowali	mailowali
mejlowaliby	mailowaliby
mejlowalibyście	mailowalibyście
mejlowalibyśmy	mailowalibyśmy
mejlowaliście	mailowaliście
mejlowaliśmy	mailowaliśmy
mejlowało	mailowało
mejlowałoby	mailowałoby
mejlowały	mailowały
mejlowałyby	mailowałyby
mejlowałybyście	mailowałybyście
mejlowałybyśmy	mailowałybyśmy
mejlowałyście	mailowałyście
mejlowałyśmy	mailowałyśmy
mejlowań	mailowań
mejlowana	mailowana
mejlowaną	mailowaną
mejlowane	mailowane
mejlowanego	mailowanego
mejlowanej	mailowanej
mejlowanemu	mailowanemu
mejlowani	mailowani
mejlowania	mailowania
mejlowaniach	mailowaniach
mejlowaniami	mailowaniami
mejlowanie	mailowanie
mejlowaniem	mailowaniem
mejlowaniom	mailowaniom
mejlowaniu	mailowaniu
mejlowano	mailowano
mejlowany	mailowany
mejlowanych	mailowanych
mejlowanym	mailowanym
mejlowanymi	mailowanymi
mejlowi	mailowi
mejlu	mailu
mejluj	mailuj
mejlują	mailują
mejlując	mailując
mejlująca	mailująca
mejlującą	mailującą
mejlujące	mailujące
mejlującego	mailującego
mejlującej	mailującej
mejlującemu	mailującemu
mejlujący	mailujący
mejlujących	mailujących
mejlującym	mailującym
mejlującymi	mailującymi
mejlujcie	mailujcie
mejlujcież	mailujcież
mejluje	mailuje
mejluję	mailuję
mejlujecie	mailujecie
mejlujemy	mailujemy
mejlujesz	mailujesz
mejlujmy	mailujmy
mejlujmyż	mailujmyż
mejlujże	mailujże
niemejlingowa	niemailingowa
niemejlingową	niemailingową
niemejlingowe	niemailingowe
niemejlingowego	niemailingowego
niemejlingowej	niemailingowej
niemejlingowemu	niemailingowemu
niemejlingowi	niemailingowi
niemejlingowy	niemailingowy
niemejlingowych	niemailingowych
niemejlingowym	niemailingowym
niemejlingowymi	niemailingowymi
niemejlowań	niemailowań
niemejlowana	niemailowana
niemejlowaną	niemailowaną
niemejlowane	niemailowane
niemejlowanego	niemailowanego
niemejlowanej	niemailowanej
niemejlowanemu	niemailowanemu
niemejlowani	niemailowani
niemejlowania	niemailowania
niemejlowaniach	niemailowaniach
niemejlowaniami	niemailowaniami
niemejlowanie	niemailowanie
niemejlowaniem	niemailowaniem
niemejlowaniom	niemailowaniom
niemejlowaniu	niemailowaniu
niemejlowany	niemailowany
niemejlowanych	niemailowanych
niemejlowanym	niemailowanym
niemejlowanymi	niemailowanymi
niemejlująca	niemailująca
niemejlującą	niemailującą
niemejlujące	niemailujące
niemejlującego	niemailującego
niemejlującej	niemailującej
niemejlującemu	niemailującemu
niemejlujący	niemailujący
niemejlujących	niemailujących
niemejlującym	niemailującym
niemejlującymi	niemailującymi
PRL-owscy	peerelowscy
PRL-owska	peerelowska
PRL-owską	peerelowską
PRL-owski	peerelowski
PRL-owskich	peerelowskich
PRL-owskie	peerelowskie
PRL-owskiego	peerelowskiego
PRL-owskiej	peerelowskiej
PRL-owskiemu	peerelowskiemu
PRL-owskim	peerelowskim
PRL-owskimi	peerelowskimi
PRL-owsko	peerelowsko
PRL-owsku	peerelowsku
PSL-owscy	peeselowscy
PSL-owska	peeselowska
PSL-owską	peeselowską
PSL-owski	peeselowski
PSL-owskich	peeselowskich
PSL-owskie	peeselowskie
PSL-owskiego	peeselowskiego
PSL-owskiej	peeselowskiej
PSL-owskiemu	peeselowskiemu
PSL-owskim	peeselowskim
PSL-owskimi	peeselowskimi
PSL-owsko	peeselowsko
PSL-owsku	peeselowsku
triathloniści	triatloniści
triathloniście	triatloniście
triathlonista	triatlonista
triathlonistą	triatlonistą
triathlonistach	triatlonistach
triathlonistami	triatlonistami
triathlonistę	triatlonistę
triathlonisto	triatlonisto
triathlonistom	triatlonistom
triathlonistów	triatlonistów
triathlonisty	triatlonisty
aaa	aa
aaaa	aa
aaaaaaaaaaaaaaaaaaaaaaaaaaaaaaa	aa
Agile’a	Agile'a
Agile’em	Agile'em
Agile’ową	Agile'ową
Agile’owe	Agile'owe
Agile’owego	Agile'owego
Agile’owym	Agile'owym
Agile’owymi	Agile'owymi
Agile’u	Agile'u
ex-kapitanowie	ekskapitanowie
dzieyopis	dziejopis
zwyczaiem	zwyczajem
kraiem	krajem
boskiey	boskiej
białoczarna	biało-czarna
białoczarną	biało-czarną
białoczarne	biało-czarne
białoczarnego	biało-czarnego
białoczarnej	biało-czarnej
białoczarnemu	biało-czarnemu
białoczarni	biało-czarni
białoczarny	biało-czarny
białoczarnych	biało-czarnych
białoczarnym	biało-czarnym
białoczarnymi	biało-czarnymi
białoczerwona	biało-czerwona
białoczerwoną	biało-czerwoną
białoczerwone	biało-czerwone
białoczerwonego	biało-czerwonego
białoczerwonej	biało-czerwonej
białoczerwonemu	biało-czerwonemu
białoczerwoni	biało-czerwoni
białoczerwononiebiescy	biało-czerwono-niebiescy
białoczerwononiebieska	biało-czerwono-niebieska
białoczerwononiebieską	biało-czerwono-niebieską
białoczerwononiebieski	biało-czerwono-niebieski
białoczerwononiebieskich	biało-czerwono-niebieskich
białoczerwononiebieskie	biało-czerwono-niebieskie
białoczerwononiebieskiego	biało-czerwono-niebieskiego
białoczerwononiebieskiej	biało-czerwono-niebieskiej
białoczerwononiebieskiemu	biało-czerwono-niebieskiemu
białoczerwononiebieskim	biało-czerwono-niebieskim
białoczerwononiebieskimi	biało-czerwono-niebieskimi
białoczerwony	biało-czerwony
białoczerwonych	biało-czerwonych
białoczerwonym	biało-czerwonym
białoczerwonymi	biało-czerwonymi
zkąd	skąd
słysałem	słyszałem
itd.,	i tak dalej,
np.,	na przykład,
Potockiéj	Potockiej
Agniészka	Agnieszka
trwożnéj	trwożnej
Drzémią	Drzemią
capricioso	capriccioso
itd.;	i tak dalej;
1-ej	pierwszej
2-ej	drugiej
3-ej	trzeciej
4-ej	czwartej
5-ej	piątej
6-ej	szóstej
7-ej	siódmej
8-ej	ósmej
9-ej	dziewiątej
10-ej	dziesiątej
11-ej	jedenastej
12-ej	dwunastej
13-ej	trzynastej
14-ej	czternastej
15-ej	piętnastej
16-ej	szesnastej
17-ej	siedemnastej
18-ej	osiemnastej
19-ej	dziewiętnastej
20-ej	dwudziestej
21-ej	dwudziestej pierwszej
22-ej	dwudziestej drugiej
23-ej	dwudziestej trzeciej
2-latce	dwulatce
2-latek	dwulatek
2-latka	dwulatka
2-latką	dwulatką
2-latkach	dwulatkach
2-latkami	dwulatkami
2-latkę	dwulatkę
2-latki	dwulatki
2-latkiem	dwulatkiem
2-latko	dwulatko
2-latkom	dwulatkom
2-latków	dwulatków
2-latkowi	dwulatkowi
2-latkowie	dwulatkowie
2-latku	dwulatku
2-letni	dwuletni
2-letnia	dwuletnia
2-letnią	dwuletnią
2-letnich	dwuletnich
2-letnie	dwuletnie
2-letniego	dwuletniego
2-letniej	dwuletniej
2-letniemu	dwuletniemu
2-letnim	dwuletnim
2-letnimi	dwuletnimi
3-latce	trzylatce
3-latek	trzylatek
3-latka	trzylatka
3-latką	trzylatką
3-latkach	trzylatkach
3-latkami	trzylatkami
3-latkę	trzylatkę
3-latki	trzylatki
3-latkiem	trzylatkiem
3-latko	trzylatko
3-latkom	trzylatkom
3-latków	trzylatków
3-latkowi	trzylatkowi
3-latkowie	trzylatkowie
3-latku	trzylatku
3-letni	trzyletni
3-letnia	trzyletnia
3-letnią	trzyletnią
3-letnich	trzyletnich
3-letnie	trzyletnie
3-letniego	trzyletniego
3-letniej	trzyletniej
3-letniemu	trzyletniemu
3-letnim	trzyletnim
3-letnimi	trzyletnimi
4-latce	czterolatce
4-latek	czterolatek
4-latka	czterolatka
4-latką	czterolatką
4-latkach	czterolatkach
4-latkami	czterolatkami
4-latkę	czterolatkę
4-latki	czterolatki
4-latkiem	czterolatkiem
4-latko	czterolatko
4-latkom	czterolatkom
4-latków	czterolatków
4-latkowi	czterolatkowi
4-latkowie	czterolatkowie
4-latku	czterolatku
4-letni	czteroletni
4-letnia	czteroletnia
4-letnią	czteroletnią
4-letnich	czteroletnich
4-letnie	czteroletnie
4-letniego	czteroletniego
4-letniej	czteroletniej
4-letniemu	czteroletniemu
4-letnim	czteroletnim
4-letnimi	czteroletnimi
5-latce	pięciolatce
5-latek	pięciolatek
5-latka	pięciolatka
5-latką	pięciolatką
5-latkach	pięciolatkach
5-latkami	pięciolatkami
5-latkę	pięciolatkę
5-latki	pięciolatki
5-latkiem	pięciolatkiem
5-latko	pięciolatko
5-latkom	pięciolatkom
5-latków	pięciolatków
5-latkowi	pięciolatkowi
5-latkowie	pięciolatkowie
5-latku	pięciolatku
5-letni	pięcioletni
5-letnia	pięcioletnia
5-letnią	pięcioletnią
5-letnich	pięcioletnich
5-letnie	pięcioletnie
5-letniego	pięcioletniego
5-letniej	pięcioletniej
5-letniemu	pięcioletniemu
5-letnim	pięcioletnim
5-letnimi	pięcioletnimi
6-latce	sześciolatce
6-latek	sześciolatek
6-latka	sześciolatka
6-latką	sześciolatką
6-latkach	sześciolatkach
6-latkami	sześciolatkami
6-latkę	sześciolatkę
6-latki	sześciolatki
6-latkiem	sześciolatkiem
6-latko	sześciolatko
6-latkom	sześciolatkom
6-latków	sześciolatków
6-latkowi	sześciolatkowi
6-latkowie	sześciolatkowie
6-latku	sześciolatku
6-letni	sześcioletni
6-letnia	sześcioletnia
6-letnią	sześcioletnią
6-letnich	sześcioletnich
6-letnie	sześcioletnie
6-letniego	sześcioletniego
6-letniej	sześcioletniej
6-letniemu	sześcioletniemu
6-letnim	sześcioletnim
6-letnimi	sześcioletnimi
7-latce	siedmiolatce
7-latek	siedmiolatek
7-latka	siedmiolatka
7-latką	siedmiolatką
7-latkach	siedmiolatkach
7-latkami	siedmiolatkami
7-latkę	siedmiolatkę
7-latki	siedmiolatki
7-latkiem	siedmiolatkiem
7-latko	siedmiolatko
7-latkom	siedmiolatkom
7-latków	siedmiolatków
7-latkowi	siedmiolatkowi
7-latkowie	siedmiolatkowie
7-latku	siedmiolatku
7-letni	siedmioletni
7-letnia	siedmioletnia
7-letnią	siedmioletnią
7-letnich	siedmioletnich
7-letnie	siedmioletnie
7-letniego	siedmioletniego
7-letniej	siedmioletniej
7-letniemu	siedmioletniemu
7-letnim	siedmioletnim
7-letnimi	siedmioletnimi
8-latce	ośmiolatce
8-latek	ośmiolatek
8-latka	ośmiolatka
8-latką	ośmiolatką
8-latkach	ośmiolatkach
8-latkami	ośmiolatkami
8-latkę	ośmiolatkę
8-latki	ośmiolatki
8-latkiem	ośmiolatkiem
8-latko	ośmiolatko
8-latkom	ośmiolatkom
8-latków	ośmiolatków
8-latkowi	ośmiolatkowi
8-latkowie	ośmiolatkowie
8-latku	ośmiolatku
8-letni	ośmioletni
8-letnia	ośmioletnia
8-letnią	ośmioletnią
8-letnich	ośmioletnich
8-letnie	ośmioletnie
8-letniego	ośmioletniego
8-letniej	ośmioletniej
8-letniemu	ośmioletniemu
8-letnim	ośmioletnim
8-letnimi	ośmioletnimi
9-latce	dziewięciolatce
9-latek	dziewięciolatek
9-latka	dziewięciolatka
9-latką	dziewięciolatką
9-latkach	dziewięciolatkach
9-latkami	dziewięciolatkami
9-latkę	dziewięciolatkę
9-latki	dziewięciolatki
9-latkiem	dziewięciolatkiem
9-latko	dziewięciolatko
9-latkom	dziewięciolatkom
9-latków	dziewięciolatków
9-latkowi	dziewięciolatkowi
9-latkowie	dziewięciolatkowie
9-latku	dziewięciolatku
9-letni	dziewięcioletni
9-letnia	dziewięcioletnia
9-letnią	dziewięcioletnią
9-letnich	dziewięcioletnich
9-letnie	dziewięcioletnie
9-letniego	dziewięcioletniego
9-letniej	dziewięcioletniej
9-letniemu	dziewięcioletniemu
9-letnim	dziewięcioletnim
9-letnimi	dziewięcioletnimi
10-latce	dziesięciolatce
10-latek	dziesięciolatek
10-latka	dziesięciolatka
10-latką	dziesięciolatką
10-latkach	dziesięciolatkach
10-latkami	dziesięciolatkami
10-latkę	dziesięciolatkę
10-latki	dziesięciolatki
10-latkiem	dziesięciolatkiem
10-latko	dziesięciolatko
10-latkom	dziesięciolatkom
10-latków	dziesięciolatków
10-latkowi	dziesięciolatkowi
10-latkowie	dziesięciolatkowie
10-latku	dziesięciolatku
10-letni	dziesięcioletni
10-letnia	dziesięcioletnia
10-letnią	dziesięcioletnią
10-letnich	dziesięcioletnich
10-letnie	dziesięcioletnie
10-letniego	dziesięcioletniego
10-letniej	dziesięcioletniej
10-letniemu	dziesięcioletniemu
10-letnim	dziesięcioletnim
10-letnimi	dziesięcioletnimi
11-latce	jedenastolatce
11-latek	jedenastolatek
11-latka	jedenastolatka
11-latką	jedenastolatką
11-latkach	jedenastolatkach
11-latkami	jedenastolatkami
11-latkę	jedenastolatkę
11-latki	jedenastolatki
11-latkiem	jedenastolatkiem
11-latko	jedenastolatko
11-latkom	jedenastolatkom
11-latków	jedenastolatków
11-latkowi	jedenastolatkowi
11-latkowie	jedenastolatkowie
11-latku	jedenastolatku
11-letni	jedenastoletni
11-letnia	jedenastoletnia
11-letnią	jedenastoletnią
11-letnich	jedenastoletnich
11-letnie	jedenastoletnie
11-letniego	jedenastoletniego
11-letniej	jedenastoletniej
11-letniemu	jedenastoletniemu
11-letnim	jedenastoletnim
11-letnimi	jedenastoletnimi
12-latce	dwunastolatce
12-latek	dwunastolatek
12-latka	dwunastolatka
12-latką	dwunastolatką
12-latkach	dwunastolatkach
12-latkami	dwunastolatkami
12-latkę	dwunastolatkę
12-latki	dwunastolatki
12-latkiem	dwunastolatkiem
12-latko	dwunastolatko
12-latkom	dwunastolatkom
12-latków	dwunastolatków
12-latkowi	dwunastolatkowi
12-latkowie	dwunastolatkowie
12-latku	dwunastolatku
12-letni	dwunastoletni
12-letnia	dwunastoletnia
12-letnią	dwunastoletnią
12-letnich	dwunastoletnich
12-letnie	dwunastoletnie
12-letniego	dwunastoletniego
12-letniej	dwunastoletniej
12-letniemu	dwunastoletniemu
12-letnim	dwunastoletnim
12-letnimi	dwunastoletnimi
13-latce	trzynastolatce
13-latek	trzynastolatek
13-latka	trzynastolatka
13-latką	trzynastolatką
13-latkach	trzynastolatkach
13-latkami	trzynastolatkami
13-latkę	trzynastolatkę
13-latki	trzynastolatki
13-latkiem	trzynastolatkiem
13-latko	trzynastolatko
13-latkom	trzynastolatkom
13-latków	trzynastolatków
13-latkowi	trzynastolatkowi
13-latkowie	trzynastolatkowie
13-latku	trzynastolatku
13-letni	trzynastoletni
13-letnia	trzynastoletnia
13-letnią	trzynastoletnią
13-letnich	trzynastoletnich
13-letnie	trzynastoletnie
13-letniego	trzynastoletniego
13-letniej	trzynastoletniej
13-letniemu	trzynastoletniemu
13-letnim	trzynastoletnim
13-letnimi	trzynastoletnimi
14-latce	czternastolatce
14-latek	czternastolatek
14-latka	czternastolatka
14-latką	czternastolatką
14-latkach	czternastolatkach
14-latkami	czternastolatkami
14-latkę	czternastolatkę
14-latki	czternastolatki
14-latkiem	czternastolatkiem
14-latko	czternastolatko
14-latkom	czternastolatkom
14-latków	czternastolatków
14-latkowi	czternastolatkowi
14-latkowie	czternastolatkowie
14-latku	czternastolatku
14-letni	czternastoletni
14-letnia	czternastoletnia
14-letnią	czternastoletnią
14-letnich	czternastoletnich
14-letnie	czternastoletnie
14-letniego	czternastoletniego
14-letniej	czternastoletniej
14-letniemu	czternastoletniemu
14-letnim	czternastoletnim
14-letnimi	czternastoletnimi
15-latce	piętnastolatce
15-latek	piętnastolatek
15-latka	piętnastolatka
15-latką	piętnastolatką
15-latkach	piętnastolatkach
15-latkami	piętnastolatkami
15-latkę	piętnastolatkę
15-latki	piętnastolatki
15-latkiem	piętnastolatkiem
15-latko	piętnastolatko
15-latkom	piętnastolatkom
15-latków	piętnastolatków
15-latkowi	piętnastolatkowi
15-latkowie	piętnastolatkowie
15-latku	piętnastolatku
15-letni	piętnastoletni
15-letnia	piętnastoletnia
15-letnią	piętnastoletnią
15-letnich	piętnastoletnich
15-letnie	piętnastoletnie
15-letniego	piętnastoletniego
15-letniej	piętnastoletniej
15-letniemu	piętnastoletniemu
15-letnim	piętnastoletnim
15-letnimi	piętnastoletnimi
16-latce	szesnastolatce
16-latek	szesnastolatek
16-latka	szesnastolatka
16-latką	szesnastolatką
16-latkach	szesnastolatkach
16-latkami	szesnastolatkami
16-latkę	szesnastolatkę
16-latki	szesnastolatki
16-latkiem	szesnastolatkiem
16-latko	szesnastolatko
16-latkom	szesnastolatkom
16-latków	szesnastolatków
16-latkowi	szesnastolatkowi
16-latkowie	szesnastolatkowie
16-latku	szesnastolatku
16-letni	szesnastoletni
16-letnia	szesnastoletnia
16-letnią	szesnastoletnią
16-letnich	szesnastoletnich
16-letnie	szesnastoletnie
16-letniego	szesnastoletniego
16-letniej	szesnastoletniej
16-letniemu	szesnastoletniemu
16-letnim	szesnastoletnim
16-letnimi	szesnastoletnimi
17-latce	siedemnastolatce
17-latek	siedemnastolatek
17-latka	siedemnastolatka
17-latką	siedemnastolatką
17-latkach	siedemnastolatkach
17-latkami	siedemnastolatkami
17-latkę	siedemnastolatkę
17-latki	siedemnastolatki
17-latkiem	siedemnastolatkiem
17-latko	siedemnastolatko
17-latkom	siedemnastolatkom
17-latków	siedemnastolatków
17-latkowi	siedemnastolatkowi
17-latkowie	siedemnastolatkowie
17-latku	siedemnastolatku
17-letni	siedemnastoletni
17-letnia	siedemnastoletnia
17-letnią	siedemnastoletnią
17-letnich	siedemnastoletnich
17-letnie	siedemnastoletnie
17-letniego	siedemnastoletniego
17-letniej	siedemnastoletniej
17-letniemu	siedemnastoletniemu
17-letnim	siedemnastoletnim
17-letnimi	siedemnastoletnimi
18-latce	osiemnastolatce
18-latek	osiemnastolatek
18-latka	osiemnastolatka
18-latką	osiemnastolatką
18-latkach	osiemnastolatkach
18-latkami	osiemnastolatkami
18-latkę	osiemnastolatkę
18-latki	osiemnastolatki
18-latkiem	osiemnastolatkiem
18-latko	osiemnastolatko
18-latkom	osiemnastolatkom
18-latków	osiemnastolatków
18-latkowi	osiemnastolatkowi
18-latkowie	osiemnastolatkowie
18-latku	osiemnastolatku
18-letni	osiemnastoletni
18-letnia	osiemnastoletnia
18-letnią	osiemnastoletnią
18-letnich	osiemnastoletnich
18-letnie	osiemnastoletnie
18-letniego	osiemnastoletniego
18-letniej	osiemnastoletniej
18-letniemu	osiemnastoletniemu
18-letnim	osiemnastoletnim
18-letnimi	osiemnastoletnimi
19-latce	dziewiętnastolatce
19-latek	dziewiętnastolatek
19-latka	dziewiętnastolatka
19-latką	dziewiętnastolatką
19-latkach	dziewiętnastolatkach
19-latkami	dziewiętnastolatkami
19-latkę	dziewiętnastolatkę
19-latki	dziewiętnastolatki
19-latkiem	dziewiętnastolatkiem
19-latko	dziewiętnastolatko
19-latkom	dziewiętnastolatkom
19-latków	dziewiętnastolatków
19-latkowi	dziewiętnastolatkowi
19-latkowie	dziewiętnastolatkowie
19-latku	dziewiętnastolatku
19-letni	dziewiętnastoletni
19-letnia	dziewiętnastoletnia
19-letnią	dziewiętnastoletnią
19-letnich	dziewiętnastoletnich
19-letnie	dziewiętnastoletnie
19-letniego	dziewiętnastoletniego
19-letniej	dziewiętnastoletniej
19-letniemu	dziewiętnastoletniemu
19-letnim	dziewiętnastoletnim
19-letnimi	dziewiętnastoletnimi
20-latce	dwudziestolatce
20-latek	dwudziestolatek
20-latka	dwudziestolatka
20-latką	dwudziestolatką
20-latkach	dwudziestolatkach
20-latkami	dwudziestolatkami
20-latkę	dwudziestolatkę
20-latki	dwudziestolatki
20-latkiem	dwudziestolatkiem
20-latko	dwudziestolatko
20-latkom	dwudziestolatkom
20-latków	dwudziestolatków
20-latkowi	dwudziestolatkowi
20-latkowie	dwudziestolatkowie
20-latku	dwudziestolatku
20-letni	dwudziestoletni
20-letnia	dwudziestoletnia
20-letnią	dwudziestoletnią
20-letnich	dwudziestoletnich
20-letnie	dwudziestoletnie
20-letniego	dwudziestoletniego
20-letniej	dwudziestoletniej
20-letniemu	dwudziestoletniemu
20-letnim	dwudziestoletnim
20-letnimi	dwudziestoletnimi
21-latce	dwudziestojednolatce
21-latek	dwudziestojednolatek
21-latka	dwudziestojednolatka
21-latką	dwudziestojednolatką
21-latkach	dwudziestojednolatkach
21-latkami	dwudziestojednolatkami
21-latkę	dwudziestojednolatkę
21-latki	dwudziestojednolatki
21-latkiem	dwudziestojednolatkiem
21-latko	dwudziestojednolatko
21-latkom	dwudziestojednolatkom
21-latków	dwudziestojednolatków
21-latkowi	dwudziestojednolatkowi
21-latkowie	dwudziestojednolatkowie
21-latku	dwudziestojednolatku
21-letni	dwudziestojednoletni
21-letnia	dwudziestojednoletnia
21-letnią	dwudziestojednoletnią
21-letnich	dwudziestojednoletnich
21-letnie	dwudziestojednoletnie
21-letniego	dwudziestojednoletniego
21-letniej	dwudziestojednoletniej
21-letniemu	dwudziestojednoletniemu
21-letnim	dwudziestojednoletnim
21-letnimi	dwudziestojednoletnimi
22-latce	dwudziestodwulatce
22-latek	dwudziestodwulatek
22-latka	dwudziestodwulatka
22-latką	dwudziestodwulatką
22-latkach	dwudziestodwulatkach
22-latkami	dwudziestodwulatkami
22-latkę	dwudziestodwulatkę
22-latki	dwudziestodwulatki
22-latkiem	dwudziestodwulatkiem
22-latko	dwudziestodwulatko
22-latkom	dwudziestodwulatkom
22-latków	dwudziestodwulatków
22-latkowi	dwudziestodwulatkowi
22-latkowie	dwudziestodwulatkowie
22-latku	dwudziestodwulatku
22-letni	dwudziestodwuletni
22-letnia	dwudziestodwuletnia
22-letnią	dwudziestodwuletnią
22-letnich	dwudziestodwuletnich
22-letnie	dwudziestodwuletnie
22-letniego	dwudziestodwuletniego
22-letniej	dwudziestodwuletniej
22-letniemu	dwudziestodwuletniemu
22-letnim	dwudziestodwuletnim
22-letnimi	dwudziestodwuletnimi
23-latce	dwudziestotrzylatce
23-latek	dwudziestotrzylatek
23-latka	dwudziestotrzylatka
23-latką	dwudziestotrzylatką
23-latkach	dwudziestotrzylatkach
23-latkami	dwudziestotrzylatkami
23-latkę	dwudziestotrzylatkę
23-latki	dwudziestotrzylatki
23-latkiem	dwudziestotrzylatkiem
23-latko	dwudziestotrzylatko
23-latkom	dwudziestotrzylatkom
23-latków	dwudziestotrzylatków
23-latkowi	dwudziestotrzylatkowi
23-latkowie	dwudziestotrzylatkowie
23-latku	dwudziestotrzylatku
23-letni	dwudziestotrzyletni
23-letnia	dwudziestotrzyletnia
23-letnią	dwudziestotrzyletnią
23-letnich	dwudziestotrzyletnich
23-letnie	dwudziestotrzyletnie
23-letniego	dwudziestotrzyletniego
23-letniej	dwudziestotrzyletniej
23-letniemu	dwudziestotrzyletniemu
23-letnim	dwudziestotrzyletnim
23-letnimi	dwudziestotrzyletnimi
24-latce	dwudziestoczterolatce
24-latek	dwudziestoczterolatek
24-latka	dwudziestoczterolatka
24-latką	dwudziestoczterolatką
24-latkach	dwudziestoczterolatkach
24-latkami	dwudziestoczterolatkami
24-latkę	dwudziestoczterolatkę
24-latki	dwudziestoczterolatki
24-latkiem	dwudziestoczterolatkiem
24-latko	dwudziestoczterolatko
24-latkom	dwudziestoczterolatkom
24-latków	dwudziestoczterolatków
24-latkowi	dwudziestoczterolatkowi
24-latkowie	dwudziestoczterolatkowie
24-latku	dwudziestoczterolatku
24-letni	dwudziestoczteroletni
24-letnia	dwudziestoczteroletnia
24-letnią	dwudziestoczteroletnią
24-letnich	dwudziestoczteroletnich
24-letnie	dwudziestoczteroletnie
24-letniego	dwudziestoczteroletniego
24-letniej	dwudziestoczteroletniej
24-letniemu	dwudziestoczteroletniemu
24-letnim	dwudziestoczteroletnim
24-letnimi	dwudziestoczteroletnimi
25-latce	dwudziestopięciolatce
25-latek	dwudziestopięciolatek
25-latka	dwudziestopięciolatka
25-latką	dwudziestopięciolatką
25-latkach	dwudziestopięciolatkach
25-latkami	dwudziestopięciolatkami
25-latkę	dwudziestopięciolatkę
25-latki	dwudziestopięciolatki
25-latkiem	dwudziestopięciolatkiem
25-latko	dwudziestopięciolatko
25-latkom	dwudziestopięciolatkom
25-latków	dwudziestopięciolatków
25-latkowi	dwudziestopięciolatkowi
25-latkowie	dwudziestopięciolatkowie
25-latku	dwudziestopięciolatku
25-letni	dwudziestopięcioletni
25-letnia	dwudziestopięcioletnia
25-letnią	dwudziestopięcioletnią
25-letnich	dwudziestopięcioletnich
25-letnie	dwudziestopięcioletnie
25-letniego	dwudziestopięcioletniego
25-letniej	dwudziestopięcioletniej
25-letniemu	dwudziestopięcioletniemu
25-letnim	dwudziestopięcioletnim
25-letnimi	dwudziestopięcioletnimi
26-latce	dwudziestosześciolatce
26-latek	dwudziestosześciolatek
26-latka	dwudziestosześciolatka
26-latką	dwudziestosześciolatką
26-latkach	dwudziestosześciolatkach
26-latkami	dwudziestosześciolatkami
26-latkę	dwudziestosześciolatkę
26-latki	dwudziestosześciolatki
26-latkiem	dwudziestosześciolatkiem
26-latko	dwudziestosześciolatko
26-latkom	dwudziestosześciolatkom
26-latków	dwudziestosześciolatków
26-latkowi	dwudziestosześciolatkowi
26-latkowie	dwudziestosześciolatkowie
26-latku	dwudziestosześciolatku
26-letni	dwudziestosześcioletni
26-letnia	dwudziestosześcioletnia
26-letnią	dwudziestosześcioletnią
26-letnich	dwudziestosześcioletnich
26-letnie	dwudziestosześcioletnie
26-letniego	dwudziestosześcioletniego
26-letniej	dwudziestosześcioletniej
26-letniemu	dwudziestosześcioletniemu
26-letnim	dwudziestosześcioletnim
26-letnimi	dwudziestosześcioletnimi
27-latce	dwudziestosiedmiolatce
27-latek	dwudziestosiedmiolatek
27-latka	dwudziestosiedmiolatka
27-latką	dwudziestosiedmiolatką
27-latkach	dwudziestosiedmiolatkach
27-latkami	dwudziestosiedmiolatkami
27-latkę	dwudziestosiedmiolatkę
27-latki	dwudziestosiedmiolatki
27-latkiem	dwudziestosiedmiolatkiem
27-latko	dwudziestosiedmiolatko
27-latkom	dwudziestosiedmiolatkom
27-latków	dwudziestosiedmiolatków
27-latkowi	dwudziestosiedmiolatkowi
27-latkowie	dwudziestosiedmiolatkowie
27-latku	dwudziestosiedmiolatku
27-letni	dwudziestosiedmioletni
27-letnia	dwudziestosiedmioletnia
27-letnią	dwudziestosiedmioletnią
27-letnich	dwudziestosiedmioletnich
27-letnie	dwudziestosiedmioletnie
27-letniego	dwudziestosiedmioletniego
27-letniej	dwudziestosiedmioletniej
27-letniemu	dwudziestosiedmioletniemu
27-letnim	dwudziestosiedmioletnim
27-letnimi	dwudziestosiedmioletnimi
28-latce	dwudziestoośmiolatce
28-latek	dwudziestoośmiolatek
28-latka	dwudziestoośmiolatka
28-latką	dwudziestoośmiolatką
28-latkach	dwudziestoośmiolatkach
28-latkami	dwudziestoośmiolatkami
28-latkę	dwudziestoośmiolatkę
28-latki	dwudziestoośmiolatki
28-latkiem	dwudziestoośmiolatkiem
28-latko	dwudziestoośmiolatko
28-latkom	dwudziestoośmiolatkom
28-latków	dwudziestoośmiolatków
28-latkowi	dwudziestoośmiolatkowi
28-latkowie	dwudziestoośmiolatkowie
28-latku	dwudziestoośmiolatku
28-letni	dwudziestoośmioletni
28-letnia	dwudziestoośmioletnia
28-letnią	dwudziestoośmioletnią
28-letnich	dwudziestoośmioletnich
28-letnie	dwudziestoośmioletnie
28-letniego	dwudziestoośmioletniego
28-letniej	dwudziestoośmioletniej
28-letniemu	dwudziestoośmioletniemu
28-letnim	dwudziestoośmioletnim
28-letnimi	dwudziestoośmioletnimi
29-latce	dwudziestodziewięciolatce
29-latek	dwudziestodziewięciolatek
29-latka	dwudziestodziewięciolatka
29-latką	dwudziestodziewięciolatką
29-latkach	dwudziestodziewięciolatkach
29-latkami	dwudziestodziewięciolatkami
29-latkę	dwudziestodziewięciolatkę
29-latki	dwudziestodziewięciolatki
29-latkiem	dwudziestodziewięciolatkiem
29-latko	dwudziestodziewięciolatko
29-latkom	dwudziestodziewięciolatkom
29-latków	dwudziestodziewięciolatków
29-latkowi	dwudziestodziewięciolatkowi
29-latkowie	dwudziestodziewięciolatkowie
29-latku	dwudziestodziewięciolatku
29-letni	dwudziestodziewięcioletni
29-letnia	dwudziestodziewięcioletnia
29-letnią	dwudziestodziewięcioletnią
29-letnich	dwudziestodziewięcioletnich
29-letnie	dwudziestodziewięcioletnie
29-letniego	dwudziestodziewięcioletniego
29-letniej	dwudziestodziewięcioletniej
29-letniemu	dwudziestodziewięcioletniemu
29-letnim	dwudziestodziewięcioletnim
29-letnimi	dwudziestodziewięcioletnimi
