ignacy-krasicki-bajki-i-przypowiesci-abuzei-i-tair.mp3	abuzei-i-tair.txt
milosz-biedrzycki-akslop.mp3	akslop.txt
autor-nieznany-aniol-pasterzom-mowil.mp3	aniol-pasterzom-mowil.txt
boleslaw-prus-antek.mp3	antek.txt
anton-czechow-aptekarzowa.mp3	aptekarzowa.txt
ignacy-krasicki-bajki-i-przypowiesci-atlas-i-kitaj.mp3	atlas-i-kitaj.txt
ignacy-krasicki-bajki-i-przypowiesci-dwa-zolwie.mp3	bajki-i-przypowiesci-dwa-zolwie.txt
ignacy-krasicki-bajki-i-przypowiesci-kulawy-i-slepy.mp3	bajki-i-przypowiesci-kulawy-i-slepy.txt
ignacy-krasicki-bajki-i-przypowiesci-lew-i-zwierzeta.mp3	bajki-i-przypowiesci-lew-i-zwierzeta.txt
jozef-czechowicz-ballada-z-tamtej-strony.mp3	ballada-z-tamtej-strony-ballada-z-tamtej-strony.txt
jozef-czechowicz-erotyk.mp3	ballada-z-tamtej-strony-erotyk.txt
jozef-czechowicz-imieniny.mp3	ballada-z-tamtej-strony-imieniny.txt
jozef-czechowicz-melancholia.mp3	ballada-z-tamtej-strony-melancholia.txt
jozef-czechowicz-wiezienie.mp3	ballada-z-tamtej-strony-wiezienie.txt
jozef-czechowicz-zdrada.mp3	ballada-z-tamtej-strony-zdrada.txt
adam-mickiewicz-ballady-i-romanse-lilje.mp3	ballady-i-romanse-lilje.txt
adam-mickiewicz-ballady-i-romanse-pani-twardowska.mp3	ballady-i-romanse-pani-twardowska.txt
adam-mickiewicz-ballady-i-romanse-powrot-taty.mp3	ballady-i-romanse-powrot-taty.txt
adam-mickiewicz-ballady-i-romanse-rekawiczka.mp3	ballady-i-romanse-rekawiczka.txt
adam-mickiewicz-ballady-i-romanse-romantycznosc.mp3	ballady-i-romanse-romantycznosc.txt
adam-mickiewicz-ballady-i-romanse-rybka.mp3	ballady-i-romanse-rybka.txt
adam-mickiewicz-ballady-i-romanse-switez.mp3	ballady-i-romanse-switez.txt
adam-mickiewicz-ballady-i-romanse-switezianka.mp3	ballady-i-romanse-switezianka.txt
honore-de-balzac-bank-nucingena.mp3	balzac-komedia-ludzka-bank-nucingena.txt
01-honore-de-balzac-eugenia-grandet.mp3	balzac-komedia-ludzka-eugenia-grandet.txt-01.txt
02-honore-de-balzac-eugenia-grandet.mp3	balzac-komedia-ludzka-eugenia-grandet.txt-02.txt
03-honore-de-balzac-eugenia-grandet.mp3	balzac-komedia-ludzka-eugenia-grandet.txt-03.txt
04-honore-de-balzac-eugenia-grandet.mp3	balzac-komedia-ludzka-eugenia-grandet.txt-04.txt
05-honore-de-balzac-eugenia-grandet.mp3	balzac-komedia-ludzka-eugenia-grandet.txt-05.txt
06-honore-de-balzac-eugenia-grandet.mp3	balzac-komedia-ludzka-eugenia-grandet.txt-06.txt
07-honore-de-balzac-eugenia-grandet.mp3	balzac-komedia-ludzka-eugenia-grandet.txt-07.txt
08-honore-de-balzac-eugenia-grandet.mp3	balzac-komedia-ludzka-eugenia-grandet.txt-08.txt
09-honore-de-balzac-eugenia-grandet.mp3	balzac-komedia-ludzka-eugenia-grandet.txt-09.txt
10-honore-de-balzac-eugenia-grandet.mp3	balzac-komedia-ludzka-eugenia-grandet.txt-10.txt
11-honore-de-balzac-eugenia-grandet.mp3	balzac-komedia-ludzka-eugenia-grandet.txt-11.txt
12-honore-de-balzac-eugenia-grandet.mp3	balzac-komedia-ludzka-eugenia-grandet.txt-12.txt
13-honore-de-balzac-eugenia-grandet.mp3	balzac-komedia-ludzka-eugenia-grandet.txt-13.txt
14-honore-de-balzac-eugenia-grandet.mp3	balzac-komedia-ludzka-eugenia-grandet.txt-14.txt
15-honore-de-balzac-eugenia-grandet.mp3	balzac-komedia-ludzka-eugenia-grandet.txt-15.txt
16-honore-de-balzac-eugenia-grandet.mp3	balzac-komedia-ludzka-eugenia-grandet.txt-16.txt
honore-de-balzac-gobseck.mp3	balzac-komedia-ludzka-gobseck.txt
01-honore-de-balzac-jaszczur-rozdzial-1-czesc-01.mp3	balzac-komedia-ludzka-jaszczur.txt
02-honore-de-balzac-jaszczur-rozdzial-1-czesc-02.mp3	balzac-komedia-ludzka-jaszczur.txt
03-honore-de-balzac-jaszczur-rozdzial-1-czesc-03.mp3	balzac-komedia-ludzka-jaszczur.txt
04-honore-de-balzac-jaszczur-rozdzial-1-czesc-04.mp3	balzac-komedia-ludzka-jaszczur.txt
05-honore-de-balzac-jaszczur-rozdzial-1-czesc-05.mp3	balzac-komedia-ludzka-jaszczur.txt
06-honore-de-balzac-jaszczur-rozdzial-2-czesc-01.mp3	balzac-komedia-ludzka-jaszczur.txt
07-honore-de-balzac-jaszczur-rozdzial-2-czesc-02.mp3	balzac-komedia-ludzka-jaszczur.txt
08-honore-de-balzac-jaszczur-rozdzial-2-czesc-03.mp3	balzac-komedia-ludzka-jaszczur.txt
09-honore-de-balzac-jaszczur-rozdzial-2-czesc-04.mp3	balzac-komedia-ludzka-jaszczur.txt
10-honore-de-balzac-jaszczur-rozdzial-2-czesc-05.mp3	balzac-komedia-ludzka-jaszczur.txt
11-honore-de-balzac-jaszczur-rozdzial-2-czesc-06.mp3	balzac-komedia-ludzka-jaszczur.txt
12-honore-de-balzac-jaszczur-rozdzial-2-czesc-07.mp3	balzac-komedia-ludzka-jaszczur.txt
13-honore-de-balzac-jaszczur-rozdzial-2-czesc-08.mp3	balzac-komedia-ludzka-jaszczur.txt
14-honore-de-balzac-jaszczur-rozdzial-2-czesc-09.mp3	balzac-komedia-ludzka-jaszczur.txt
15-honore-de-balzac-jaszczur-rozdzial-3-czesc-01.mp3	balzac-komedia-ludzka-jaszczur.txt
16-honore-de-balzac-jaszczur-rozdzial-3-czesc-02.mp3	balzac-komedia-ludzka-jaszczur.txt
17-honore-de-balzac-jaszczur-rozdzial-3-czesc-03.mp3	balzac-komedia-ludzka-jaszczur.txt
18-honore-de-balzac-jaszczur-rozdzial-3-czesc-04.mp3	balzac-komedia-ludzka-jaszczur.txt
19-honore-de-balzac-jaszczur-rozdzial-3-czesc-05.mp3	balzac-komedia-ludzka-jaszczur.txt
20-honore-de-balzac-jaszczur-rozdzial-3-czesc-06.mp3	balzac-komedia-ludzka-jaszczur.txt
21-honore-de-balzac-jaszczur-rozdzial-3-czesc-07.mp3	balzac-komedia-ludzka-jaszczur.txt
22-honore-de-balzac-jaszczur-rozdzial-3-czesc-08.mp3	balzac-komedia-ludzka-jaszczur.txt
honore-de-balzac-kobieta-porzucona.mp3	balzac-komedia-ludzka-kobieta-porzucona.txt
01-honore-de-balzac-kobieta-trzydziestoletnia-pierwsze-bledy.mp3	balzac-komedia-ludzka-kobieta-trzydziestoletnia.txt
02-honore-de-balzac-kobieta-trzydziestoletnia-nieznane-cierpienia.mp3	balzac-komedia-ludzka-kobieta-trzydziestoletnia.txt
03-honore-de-balzac-kobieta-trzydziestoletnia-kobieta-trzydziestoletnia.mp3	balzac-komedia-ludzka-kobieta-trzydziestoletnia.txt
04-honore-de-balzac-kobieta-trzydziestoletnia-palec-bozy.mp3	balzac-komedia-ludzka-kobieta-trzydziestoletnia.txt
05-honore-de-balzac-kobieta-trzydziestoletnia-dwa-spotkania.mp3	balzac-komedia-ludzka-kobieta-trzydziestoletnia.txt
06-honore-de-balzac-kobieta-trzydziestoletnia-starosc-wystepnej-matki.mp3	balzac-komedia-ludzka-kobieta-trzydziestoletnia.txt
01-honore-de-balzac-male-niedole-pozycia-malzenskiego-od-tlumacza.mp3	balzac-komedia-ludzka-male-niedole-pozycia-malzenskiego.txt
02-honore-de-balzac-male-niedole-pozycia-malzenskiego-czesc-1-przedmowa.mp3	balzac-komedia-ludzka-male-niedole-pozycia-malzenskiego.txt
03-honore-de-balzac-male-niedole-pozycia-malzenskiego-rozdzial-01.mp3	balzac-komedia-ludzka-male-niedole-pozycia-malzenskiego.txt
04-honore-de-balzac-male-niedole-pozycia-malzenskiego-rozdzial-02.mp3	balzac-komedia-ludzka-male-niedole-pozycia-malzenskiego.txt
05-honore-de-balzac-male-niedole-pozycia-malzenskiego-rozdzial-03.mp3	balzac-komedia-ludzka-male-niedole-pozycia-malzenskiego.txt
06-honore-de-balzac-male-niedole-pozycia-malzenskiego-rozdzial-04.mp3	balzac-komedia-ludzka-male-niedole-pozycia-malzenskiego.txt
07-honore-de-balzac-male-niedole-pozycia-malzenskiego-rozdzial-05.mp3	balzac-komedia-ludzka-male-niedole-pozycia-malzenskiego.txt
08-honore-de-balzac-male-niedole-pozycia-malzenskiego-rozdzial-06.mp3	balzac-komedia-ludzka-male-niedole-pozycia-malzenskiego.txt
09-honore-de-balzac-male-niedole-pozycia-malzenskiego-rozdzial-07.mp3	balzac-komedia-ludzka-male-niedole-pozycia-malzenskiego.txt
10-honore-de-balzac-male-niedole-pozycia-malzenskiego-rozdzial-08.mp3	balzac-komedia-ludzka-male-niedole-pozycia-malzenskiego.txt
11-honore-de-balzac-male-niedole-pozycia-malzenskiego-rozdzial-09.mp3	balzac-komedia-ludzka-male-niedole-pozycia-malzenskiego.txt
12-honore-de-balzac-male-niedole-pozycia-malzenskiego-rozdzial-10.mp3	balzac-komedia-ludzka-male-niedole-pozycia-malzenskiego.txt
13-honore-de-balzac-male-niedole-pozycia-malzenskiego-rozdzial-11.mp3	balzac-komedia-ludzka-male-niedole-pozycia-malzenskiego.txt
14-honore-de-balzac-male-niedole-pozycia-malzenskiego-rozdzial-12.mp3	balzac-komedia-ludzka-male-niedole-pozycia-malzenskiego.txt
15-honore-de-balzac-male-niedole-pozycia-malzenskiego-rozdzial-13.mp3	balzac-komedia-ludzka-male-niedole-pozycia-malzenskiego.txt
16-honore-de-balzac-male-niedole-pozycia-malzenskiego-rozdzial-14.mp3	balzac-komedia-ludzka-male-niedole-pozycia-malzenskiego.txt
17-honore-de-balzac-male-niedole-pozycia-malzenskiego-rozdzial-15.mp3	balzac-komedia-ludzka-male-niedole-pozycia-malzenskiego.txt
18-honore-de-balzac-male-niedole-pozycia-malzenskiego-rozdzial-16.mp3	balzac-komedia-ludzka-male-niedole-pozycia-malzenskiego.txt
19-honore-de-balzac-male-niedole-pozycia-malzenskiego-rozdzial-17.mp3	balzac-komedia-ludzka-male-niedole-pozycia-malzenskiego.txt
20-honore-de-balzac-male-niedole-pozycia-malzenskiego-rozdzial-18.mp3	balzac-komedia-ludzka-male-niedole-pozycia-malzenskiego.txt
21-honore-de-balzac-male-niedole-pozycia-malzenskiego-czesc-2-przedmowa.mp3	balzac-komedia-ludzka-male-niedole-pozycia-malzenskiego.txt
22-honore-de-balzac-male-niedole-pozycia-malzenskiego-rozdzial-19.mp3	balzac-komedia-ludzka-male-niedole-pozycia-malzenskiego.txt
23-honore-de-balzac-male-niedole-pozycia-malzenskiego-rozdzial-20.mp3	balzac-komedia-ludzka-male-niedole-pozycia-malzenskiego.txt
24-honore-de-balzac-male-niedole-pozycia-malzenskiego-rozdzial-21.mp3	balzac-komedia-ludzka-male-niedole-pozycia-malzenskiego.txt
25-honore-de-balzac-male-niedole-pozycia-malzenskiego-rozdzial-22.mp3	balzac-komedia-ludzka-male-niedole-pozycia-malzenskiego.txt
26-honore-de-balzac-male-niedole-pozycia-malzenskiego-rozdzial-23.mp3	balzac-komedia-ludzka-male-niedole-pozycia-malzenskiego.txt
27-honore-de-balzac-male-niedole-pozycia-malzenskiego-rozdzial-24.mp3	balzac-komedia-ludzka-male-niedole-pozycia-malzenskiego.txt
28-honore-de-balzac-male-niedole-pozycia-malzenskiego-rozdzial-25.mp3	balzac-komedia-ludzka-male-niedole-pozycia-malzenskiego.txt
29-honore-de-balzac-male-niedole-pozycia-malzenskiego-rozdzial-26.mp3	balzac-komedia-ludzka-male-niedole-pozycia-malzenskiego.txt
30-honore-de-balzac-male-niedole-pozycia-malzenskiego-rozdzial-27.mp3	balzac-komedia-ludzka-male-niedole-pozycia-malzenskiego.txt
31-honore-de-balzac-male-niedole-pozycia-malzenskiego-rozdzial-28.mp3	balzac-komedia-ludzka-male-niedole-pozycia-malzenskiego.txt
32-honore-de-balzac-male-niedole-pozycia-malzenskiego-rozdzial-29.mp3	balzac-komedia-ludzka-male-niedole-pozycia-malzenskiego.txt
33-honore-de-balzac-male-niedole-pozycia-malzenskiego-rozdzial-30.mp3	balzac-komedia-ludzka-male-niedole-pozycia-malzenskiego.txt
34-honore-de-balzac-male-niedole-pozycia-malzenskiego-rozdzial-31.mp3	balzac-komedia-ludzka-male-niedole-pozycia-malzenskiego.txt
35-honore-de-balzac-male-niedole-pozycia-malzenskiego-rozdzial-32.mp3	balzac-komedia-ludzka-male-niedole-pozycia-malzenskiego.txt
36-honore-de-balzac-male-niedole-pozycia-malzenskiego-rozdzial-33.mp3	balzac-komedia-ludzka-male-niedole-pozycia-malzenskiego.txt
37-honore-de-balzac-male-niedole-pozycia-malzenskiego-rozdzial-34.mp3	balzac-komedia-ludzka-male-niedole-pozycia-malzenskiego.txt
38-honore-de-balzac-male-niedole-pozycia-malzenskiego-rozdzial-35.mp3	balzac-komedia-ludzka-male-niedole-pozycia-malzenskiego.txt
39-honore-de-balzac-male-niedole-pozycia-malzenskiego-rozdzial-36.mp3	balzac-komedia-ludzka-male-niedole-pozycia-malzenskiego.txt
40-honore-de-balzac-male-niedole-pozycia-malzenskiego-rozdzial-37.mp3	balzac-komedia-ludzka-male-niedole-pozycia-malzenskiego.txt
01-honore-de-balzac-muza-z-zascianka.mp3	balzac-komedia-ludzka-muza-z-zascianka.txt
02-honore-de-balzac-muza-z-zascianka.mp3	balzac-komedia-ludzka-muza-z-zascianka.txt
03-honore-de-balzac-muza-z-zascianka.mp3	balzac-komedia-ludzka-muza-z-zascianka.txt
04-honore-de-balzac-muza-z-zascianka.mp3	balzac-komedia-ludzka-muza-z-zascianka.txt
05-honore-de-balzac-muza-z-zascianka.mp3	balzac-komedia-ludzka-muza-z-zascianka.txt
06-honore-de-balzac-muza-z-zascianka.mp3	balzac-komedia-ludzka-muza-z-zascianka.txt
07-honore-de-balzac-muza-z-zascianka.mp3	balzac-komedia-ludzka-muza-z-zascianka.txt
08-honore-de-balzac-muza-z-zascianka.mp3	balzac-komedia-ludzka-muza-z-zascianka.txt
09-honore-de-balzac-muza-z-zascianka.mp3	balzac-komedia-ludzka-muza-z-zascianka.txt
10-honore-de-balzac-muza-z-zascianka.mp3	balzac-komedia-ludzka-muza-z-zascianka.txt
11-honore-de-balzac-muza-z-zascianka.mp3	balzac-komedia-ludzka-muza-z-zascianka.txt
12-honore-de-balzac-muza-z-zascianka.mp3	balzac-komedia-ludzka-muza-z-zascianka.txt
13-honore-de-balzac-muza-z-zascianka.mp3	balzac-komedia-ludzka-muza-z-zascianka.txt
14-honore-de-balzac-muza-z-zascianka.mp3	balzac-komedia-ludzka-muza-z-zascianka.txt
15-honore-de-balzac-muza-z-zascianka.mp3	balzac-komedia-ludzka-muza-z-zascianka.txt
16-honore-de-balzac-muza-z-zascianka.mp3	balzac-komedia-ludzka-muza-z-zascianka.txt
ignacy-krasicki-bajki-i-przypowiesci-baran-dany-na-ofiare.mp3	baran-dany-na-ofiare.txt
01-henryk-sienkiewicz-bartek-zwyciezca.mp3	bartek-zwyciezca.txt
02-henryk-sienkiewicz-bartek-zwyciezca.mp3	bartek-zwyciezca.txt
03-henryk-sienkiewicz-bartek-zwyciezca.mp3	bartek-zwyciezca.txt
04-henryk-sienkiewicz-bartek-zwyciezca.mp3	bartek-zwyciezca.txt
05-henryk-sienkiewicz-bartek-zwyciezca.mp3	bartek-zwyciezca.txt
06-henryk-sienkiewicz-bartek-zwyciezca.mp3	bartek-zwyciezca.txt
07-henryk-sienkiewicz-bartek-zwyciezca.mp3	bartek-zwyciezca.txt
08-henryk-sienkiewicz-bartek-zwyciezca.mp3	bartek-zwyciezca.txt
09-henryk-sienkiewicz-bartek-zwyciezca.mp3	bartek-zwyciezca.txt
10-henryk-sienkiewicz-bartek-zwyciezca.mp3	bartek-zwyciezca.txt
edgar-allan-poe-beczka-amontillada.mp3	beczka-amontillada.txt
cyprian-kamil-norwid-bema-pamieci-zalobny-rapsod.mp3	bema-pamieci-zalobny-rapsod.txt
edgar-allan-poe-berenice.mp3	berenice.txt
anton-czechow-bezbronna-istota.mp3	bezbronna-istota.txt
jacob-i-wilhelm-grimm-bialosniezka-i-rozanka.mp3	bialosniezka-i-rozanka.txt
jacob-i-wilhelm-grimm-biedny-mlynarczyk-i-kotek.mp3	biedny-mlynarczyk-i-kotek.txt
ignacy-krasicki-bajki-i-przypowiesci-bogacz-i-zebrak.mp3	bogacz-i-zebrak.txt
autor-nieznany-bogurodzica.mp3	bogurodzica.txt
autor-nieznany-bracia-patrzcie-jeno.mp3	bracia-patrzcie-jeno.txt
ignacy-krasicki-bajki-i-przypowiesci-bryla-lodu-i-krysztal.mp3	bryla-lodu-i-krysztal.txt
ignacy-krasicki-bajki-i-przypowiesci-brytan-w-obrozy.mp3	brytan-w-obrozy.txt
hans-christian-andersen-brzydkie-kaczatko_1.mp3	brzydkie-kaczatko.txt
bruno-jasienski-but-w-butonierce-tomik-but-w-butonierce.mp3	but-w-butonierce-but-w-butonierce.txt
bruno-jasienski-but-w-butonierce-tomik-cafe.mp3	but-w-butonierce-cafe.txt
bruno-jasienski-but-w-butonierce-tomik-but-w-butonierce-dedykacja.mp3	but-w-butonierce-dedykacja.txt
bruno-jasienski-but-w-butonierce-tomik-deszcz.mp3	but-w-butonierce-deszcz.txt
bruno-jasienski-but-w-butonierce-tomik-intermezzo-czy-widzieliscie.mp3	but-w-butonierce-intermezzo-czy-widzieliscie.txt
bruno-jasienski-but-w-butonierce-tomik-intermezzo-zielone-sa-rece-moje.mp3	but-w-butonierce-intermezzo-zielone-sa-rece-moje.txt
bruno-jasienski-but-w-butonierce-tomik-ipecacuana.mp3	but-w-butonierce-ipecacuana.txt
bruno-jasienski-but-w-butonierce-tomik-jak-introdukcja.mp3	but-w-butonierce-jak-introdukcja.txt
bruno-jasienski-but-w-butonierce-tomik-lili-nudzi-sie.mp3	but-w-butonierce-lili-nudzi-sie.txt
bruno-jasienski-but-w-butonierce-tomik-marsz.mp3	but-w-butonierce-marsz.txt
bruno-jasienski-but-w-butonierce-tomik-miasto.mp3	but-w-butonierce-miasto.txt
bruno-jasienski-but-w-butonierce-tomik-milosc-na-aucie.mp3	but-w-butonierce-milosc-na-aucie.txt
bruno-jasienski-but-w-butonierce-tomik-morga.mp3	but-w-butonierce-morga.txt
bruno-jasienski-but-w-butonierce-tomik-na-bis.mp3	but-w-butonierce-na-bis.txt
bruno-jasienski-but-w-butonierce-tomik-nic.mp3	but-w-butonierce-nic.txt
bruno-jasienski-but-w-butonierce-tomik-panienki-w-lesie.mp3	but-w-butonierce-panienki-w-lesie.txt
bruno-jasienski-but-w-butonierce-tomik-perche.mp3	but-w-butonierce-perche.txt
bruno-jasienski-but-w-butonierce-tomik-podrozniczki.mp3	but-w-butonierce-podrozniczki.txt
bruno-jasienski-but-w-butonierce-tomik-prozowierszem.mp3	but-w-butonierce-prozowierszem.txt
bruno-jasienski-but-w-butonierce-tomik-przejechali.mp3	but-w-butonierce-przejechali.txt
bruno-jasienski-but-w-butonierce-tomik-smierc-pana-premiera.mp3	but-w-butonierce-smierc-pana-premiera.txt
bruno-jasienski-but-w-butonierce-tomik-snieg.mp3	but-w-butonierce-snieg.txt
bruno-jasienski-but-w-butonierce-tomik-spacer.mp3	but-w-butonierce-spacer.txt
bruno-jasienski-but-w-butonierce-tomik-tango-jesienne.mp3	but-w-butonierce-tango-jesienne.txt
bruno-jasienski-but-w-butonierce-tomik-trupy-z-kawiorem.mp3	but-w-butonierce-trupy-z-kawiorem.txt
bruno-jasienski-but-w-butonierce-tomik-wiosna.mp3	but-w-butonierce-wiosna.txt
bruno-jasienski-but-w-butonierce-tomik-zygajace-posagi.mp3	but-w-butonierce-zygajace-posagi.txt
hans-christian-andersen-calineczka.mp3	calineczka.txt
ignacy-krasicki-bajki-i-przypowiesci-chart-i-kotka.mp3	chart-i-kotka.txt
jacob-i-wilhelm-grimm-chata-w-lesie.mp3	chata-w-lesie.txt
ignacy-krasicki-bajki-i-przypowiesci-chleb-i-szabla.mp3	chleb-i-szabla.txt
01-wladyslaw-stanislaw-reymont-chlopi-chlopi-czesc-pierwsza-jesien.mp3	chlopi-czesc-pierwsza-jesien.txt
02-wladyslaw-stanislaw-reymont-chlopi-chlopi-czesc-pierwsza-jesien.mp3	chlopi-czesc-pierwsza-jesien.txt
03-wladyslaw-stanislaw-reymont-chlopi-chlopi-czesc-pierwsza-jesien.mp3	chlopi-czesc-pierwsza-jesien.txt
04-wladyslaw-stanislaw-reymont-chlopi-chlopi-czesc-pierwsza-jesien.mp3	chlopi-czesc-pierwsza-jesien.txt
05-wladyslaw-stanislaw-reymont-chlopi-chlopi-czesc-pierwsza-jesien.mp3	chlopi-czesc-pierwsza-jesien.txt
06-wladyslaw-stanislaw-reymont-chlopi-chlopi-czesc-pierwsza-jesien.mp3	chlopi-czesc-pierwsza-jesien.txt
07-wladyslaw-stanislaw-reymont-chlopi-chlopi-czesc-pierwsza-jesien.mp3	chlopi-czesc-pierwsza-jesien.txt
08-wladyslaw-stanislaw-reymont-chlopi-chlopi-czesc-pierwsza-jesien.mp3	chlopi-czesc-pierwsza-jesien.txt
09-wladyslaw-stanislaw-reymont-chlopi-chlopi-czesc-pierwsza-jesien.mp3	chlopi-czesc-pierwsza-jesien.txt
10-wladyslaw-stanislaw-reymont-chlopi-chlopi-czesc-pierwsza-jesien.mp3	chlopi-czesc-pierwsza-jesien.txt
11-wladyslaw-stanislaw-reymont-chlopi-chlopi-czesc-pierwsza-jesien.mp3	chlopi-czesc-pierwsza-jesien.txt
12-wladyslaw-stanislaw-reymont-chlopi-chlopi-czesc-pierwsza-jesien.mp3	chlopi-czesc-pierwsza-jesien.txt
joseph-mohr-cicha-noc.mp3	cicha-noc.txt
01-johann-wolfgang-von-goethe-cierpienia-mlodego-wertera.mp3	cierpienia-mlodego-wertera.txt
02-johann-wolfgang-von-goethe-cierpienia-mlodego-wertera.mp3	cierpienia-mlodego-wertera.txt
anton-czechow-cora-albionu.mp3	cora-albionu.txt
cyprian-kamil-norwid-cos-ty-atenom-zrobil-sokratesie.mp3	cos-ty-atenom-zrobil-sokratesie.txt
jan-andrzej-morsztyn-cuda-milosci-karmie-frasunkiem-milosc-i-mysleniem.mp3	cuda-milosci-karmie-frasunkiem-milosc-i-mysleniem.txt
jan-andrzej-morsztyn-cuda-milosci-przebog-jak-zyje-serca-juz-nie-majac.mp3	cuda-milosci-przebog-jak-zyje-serca-juz-nie-majac.txt
edgar-allan-poe-czarny-kot.mp3	czarny-kot.txt
anton-czechow-zemsta.mp3	czechow-zemsta.txt
ignacy-krasicki-bajki-i-przypowiesci-czlowiek-i-suknia.mp3	czlowiek-i-suknia.txt
ignacy-krasicki-bajki-i-przypowiesci-czlowiek-i-wilk.mp3	czlowiek-i-wilk.txt
ignacy-krasicki-bajki-i-przypowiesci-czlowiek-i-zdrowie.mp3	czlowiek-i-zdrowie.txt
ignacy-krasicki-bajki-i-przypowiesci-czlowiek-i-zwierciadla.mp3	czlowiek-i-zwierciadla.txt
ignacy-krasicki-bajki-i-przypowiesci-dab-i-dynia.mp3	dab-i-dynia.txt
ignacy-krasicki-bajki-i-przypowiesci-dab-i-male-drzewka.mp3	dab-i-male-drzewka.txt
maria-dabrowska-boze-narodzenie.mp3	dabrowska-boze-narodzenie.txt
maria-dabrowska-dzikie-ziele.mp3	dabrowska-dzikie-ziele.txt
anton-czechow-damy.mp3	damy.txt
ignacy-krasicki-bajki-i-przypowiesci-daremna-praca.mp3	daremna-praca.txt
adam-asnyk-daremne-zale_1.mp3	daremne-zale.txt
ignacy-krasicki-bajki-i-przypowiesci-derwisz-i-uczen.mp3	derwisz-i-uczen.txt
ignacy-krasicki-bajki-i-przypowiesci-dewotka.mp3	dewotka.txt
edgar-allan-poe-diabel-na-wiezy.mp3	diabel-na-wiezy.txt
ignacy-krasicki-bajki-i-przypowiesci-diament-i-krysztal.mp3	diament-i-krysztal.txt
anton-czechow-dlugi-jezyk.mp3	dlugi-jezyk.txt
ignacy-krasicki-bajki-i-przypowiesci-dobroczynnosc.mp3	dobroczynnosc.txt
milosz-biedrzycki-dobry-wieczor-nazywam-sie-mickiewicz.mp3	dobry-wieczor-nazywam-sie-mickiewicz.txt
franciszek-karpinski-do-justyny.mp3	do-justyny.txt
ignacy-krasicki-bajki-i-przypowiesci-doktor.mp3	doktor.txt
ignacy-krasicki-bajki-i-przypowiesci-doktor-i-zdrowie.mp3	doktor-i-zdrowie.txt
stefan-zeromski-doktor-piotr.mp3	doktor-piotr.txt
juliusz-slowacki-do-matki-zadrzy-ci-nieraz-serce-mila-matko-moja.mp3	do-matki.txt
adam-asnyk-do-mlodych.mp3	do-mlodych.txt
jan-andrzej-morsztyn-do-motyla.mp3	do-motyla.txt
001-miguel-de-cervantes-saavedra-don-kichot-z-la-manchy-ksiega-01-rozdzial-01.mp3	don-kichot-z-la-manchy.txt
002-miguel-de-cervantes-saavedra-don-kichot-z-la-manchy-ksiega-01-rozdzial-02.mp3	don-kichot-z-la-manchy.txt
003-miguel-de-cervantes-saavedra-don-kichot-z-la-manchy-ksiega-01-rozdzial-03.mp3	don-kichot-z-la-manchy.txt
004-miguel-de-cervantes-saavedra-don-kichot-z-la-manchy-ksiega-01-rozdzial-04.mp3	don-kichot-z-la-manchy.txt
005-miguel-de-cervantes-saavedra-don-kichot-z-la-manchy-ksiega-01-rozdzial-05.mp3	don-kichot-z-la-manchy.txt
006-miguel-de-cervantes-saavedra-don-kichot-z-la-manchy-ksiega-01-rozdzial-06.mp3	don-kichot-z-la-manchy.txt
007-miguel-de-cervantes-saavedra-don-kichot-z-la-manchy-ksiega-01-rozdzial-07.mp3	don-kichot-z-la-manchy.txt
008-miguel-de-cervantes-saavedra-don-kichot-z-la-manchy-ksiega-01-rozdzial-08.mp3	don-kichot-z-la-manchy.txt
009-miguel-de-cervantes-saavedra-don-kichot-z-la-manchy-ksiega-02-rozdzial-01.mp3	don-kichot-z-la-manchy.txt
010-miguel-de-cervantes-saavedra-don-kichot-z-la-manchy-ksiega-02-rozdzial-02.mp3	don-kichot-z-la-manchy.txt
011-miguel-de-cervantes-saavedra-don-kichot-z-la-manchy-ksiega-02-rozdzial-03.mp3	don-kichot-z-la-manchy.txt
012-miguel-de-cervantes-saavedra-don-kichot-z-la-manchy-ksiega-02-rozdzial-04.mp3	don-kichot-z-la-manchy.txt
013-miguel-de-cervantes-saavedra-don-kichot-z-la-manchy-ksiega-02-rozdzial-05.mp3	don-kichot-z-la-manchy.txt
014-miguel-de-cervantes-saavedra-don-kichot-z-la-manchy-ksiega-02-rozdzial-06.mp3	don-kichot-z-la-manchy.txt
015-miguel-de-cervantes-saavedra-don-kichot-z-la-manchy-ksiega-03-rozdzial-01.mp3	don-kichot-z-la-manchy.txt
016-miguel-de-cervantes-saavedra-don-kichot-z-la-manchy-ksiega-03-rozdzial-02.mp3	don-kichot-z-la-manchy.txt
017-miguel-de-cervantes-saavedra-don-kichot-z-la-manchy-ksiega-03-rozdzial-03.mp3	don-kichot-z-la-manchy.txt
018-miguel-de-cervantes-saavedra-don-kichot-z-la-manchy-ksiega-03-rozdzial-04.mp3	don-kichot-z-la-manchy.txt
019-miguel-de-cervantes-saavedra-don-kichot-z-la-manchy-ksiega-03-rozdzial-05.mp3	don-kichot-z-la-manchy.txt
020-miguel-de-cervantes-saavedra-don-kichot-z-la-manchy-ksiega-03-rozdzial-06.mp3	don-kichot-z-la-manchy.txt
021-miguel-de-cervantes-saavedra-don-kichot-z-la-manchy-ksiega-03-rozdzial-07.mp3	don-kichot-z-la-manchy.txt
022-miguel-de-cervantes-saavedra-don-kichot-z-la-manchy-ksiega-03-rozdzial-08.mp3	don-kichot-z-la-manchy.txt
023-miguel-de-cervantes-saavedra-don-kichot-z-la-manchy-ksiega-03-rozdzial-09.mp3	don-kichot-z-la-manchy.txt
024-miguel-de-cervantes-saavedra-don-kichot-z-la-manchy-ksiega-03-rozdzial-10.mp3	don-kichot-z-la-manchy.txt
025-miguel-de-cervantes-saavedra-don-kichot-z-la-manchy-ksiega-03-rozdzial-11.mp3	don-kichot-z-la-manchy.txt
026-miguel-de-cervantes-saavedra-don-kichot-z-la-manchy-ksiega-03-rozdzial-12.mp3	don-kichot-z-la-manchy.txt
027-miguel-de-cervantes-saavedra-don-kichot-z-la-manchy-ksiega-03-rozdzial-13.mp3	don-kichot-z-la-manchy.txt
028-miguel-de-cervantes-saavedra-don-kichot-z-la-manchy-ksiega-04-rozdzial-01.mp3	don-kichot-z-la-manchy.txt
029-miguel-de-cervantes-saavedra-don-kichot-z-la-manchy-ksiega-04-rozdzial-02.mp3	don-kichot-z-la-manchy.txt
030-miguel-de-cervantes-saavedra-don-kichot-z-la-manchy-ksiega-04-rozdzial-03.mp3	don-kichot-z-la-manchy.txt
031-miguel-de-cervantes-saavedra-don-kichot-z-la-manchy-ksiega-04-rozdzial-04.mp3	don-kichot-z-la-manchy.txt
032-miguel-de-cervantes-saavedra-don-kichot-z-la-manchy-ksiega-04-rozdzial-05.mp3	don-kichot-z-la-manchy.txt
033-miguel-de-cervantes-saavedra-don-kichot-z-la-manchy-ksiega-04-rozdzial-06.mp3	don-kichot-z-la-manchy.txt
034-miguel-de-cervantes-saavedra-don-kichot-z-la-manchy-ksiega-04-rozdzial-07.mp3	don-kichot-z-la-manchy.txt
035-miguel-de-cervantes-saavedra-don-kichot-z-la-manchy-ksiega-04-rozdzial-08.mp3	don-kichot-z-la-manchy.txt
036-miguel-de-cervantes-saavedra-don-kichot-z-la-manchy-ksiega-04-rozdzial-09.mp3	don-kichot-z-la-manchy.txt
037-miguel-de-cervantes-saavedra-don-kichot-z-la-manchy-ksiega-04-rozdzial-10.mp3	don-kichot-z-la-manchy.txt
038-miguel-de-cervantes-saavedra-don-kichot-z-la-manchy-ksiega-04-rozdzial-11.mp3	don-kichot-z-la-manchy.txt
039-miguel-de-cervantes-saavedra-don-kichot-z-la-manchy-ksiega-04-rozdzial-12.mp3	don-kichot-z-la-manchy.txt
040-miguel-de-cervantes-saavedra-don-kichot-z-la-manchy-ksiega-04-rozdzial-13.mp3	don-kichot-z-la-manchy.txt
041-miguel-de-cervantes-saavedra-don-kichot-z-la-manchy-ksiega-04-rozdzial-14.mp3	don-kichot-z-la-manchy.txt
042-miguel-de-cervantes-saavedra-don-kichot-z-la-manchy-ksiega-04-rozdzial-15.mp3	don-kichot-z-la-manchy.txt
043-miguel-de-cervantes-saavedra-don-kichot-z-la-manchy-ksiega-04-rozdzial-16.mp3	don-kichot-z-la-manchy.txt
044-miguel-de-cervantes-saavedra-don-kichot-z-la-manchy-ksiega-04-rozdzial-17.mp3	don-kichot-z-la-manchy.txt
045-miguel-de-cervantes-saavedra-don-kichot-z-la-manchy-ksiega-04-rozdzial-18.mp3	don-kichot-z-la-manchy.txt
046-miguel-de-cervantes-saavedra-don-kichot-z-la-manchy-ksiega-04-rozdzial-19.mp3	don-kichot-z-la-manchy.txt
047-miguel-de-cervantes-saavedra-don-kichot-z-la-manchy-ksiega-04-rozdzial-20.mp3	don-kichot-z-la-manchy.txt
048-miguel-de-cervantes-saavedra-don-kichot-z-la-manchy-ksiega-04-rozdzial-21.mp3	don-kichot-z-la-manchy.txt
049-miguel-de-cervantes-saavedra-don-kichot-z-la-manchy-ksiega-04-rozdzial-22.mp3	don-kichot-z-la-manchy.txt
050-miguel-de-cervantes-saavedra-don-kichot-z-la-manchy-ksiega-04-rozdzial-23.mp3	don-kichot-z-la-manchy.txt
051-miguel-de-cervantes-saavedra-don-kichot-z-la-manchy-ksiega-04-rozdzial-24.mp3	don-kichot-z-la-manchy.txt
052-miguel-de-cervantes-saavedra-don-kichot-z-la-manchy-ksiega-05-rozdzial-01.mp3	don-kichot-z-la-manchy.txt
053-miguel-de-cervantes-saavedra-don-kichot-z-la-manchy-ksiega-05-rozdzial-02.mp3	don-kichot-z-la-manchy.txt
054-miguel-de-cervantes-saavedra-don-kichot-z-la-manchy-ksiega-05-rozdzial-03.mp3	don-kichot-z-la-manchy.txt
055-miguel-de-cervantes-saavedra-don-kichot-z-la-manchy-ksiega-05-rozdzial-04.mp3	don-kichot-z-la-manchy.txt
056-miguel-de-cervantes-saavedra-don-kichot-z-la-manchy-ksiega-05-rozdzial-05.mp3	don-kichot-z-la-manchy.txt
057-miguel-de-cervantes-saavedra-don-kichot-z-la-manchy-ksiega-05-rozdzial-06.mp3	don-kichot-z-la-manchy.txt
058-miguel-de-cervantes-saavedra-don-kichot-z-la-manchy-ksiega-05-rozdzial-07.mp3	don-kichot-z-la-manchy.txt
059-miguel-de-cervantes-saavedra-don-kichot-z-la-manchy-ksiega-05-rozdzial-08.mp3	don-kichot-z-la-manchy.txt
060-miguel-de-cervantes-saavedra-don-kichot-z-la-manchy-ksiega-05-rozdzial-09.mp3	don-kichot-z-la-manchy.txt
061-miguel-de-cervantes-saavedra-don-kichot-z-la-manchy-ksiega-05-rozdzial-10.mp3	don-kichot-z-la-manchy.txt
062-miguel-de-cervantes-saavedra-don-kichot-z-la-manchy-ksiega-05-rozdzial-11.mp3	don-kichot-z-la-manchy.txt
063-miguel-de-cervantes-saavedra-don-kichot-z-la-manchy-ksiega-05-rozdzial-12.mp3	don-kichot-z-la-manchy.txt
064-miguel-de-cervantes-saavedra-don-kichot-z-la-manchy-ksiega-05-rozdzial-13.mp3	don-kichot-z-la-manchy.txt
065-miguel-de-cervantes-saavedra-don-kichot-z-la-manchy-ksiega-05-rozdzial-14.mp3	don-kichot-z-la-manchy.txt
066-miguel-de-cervantes-saavedra-don-kichot-z-la-manchy-ksiega-05-rozdzial-15.mp3	don-kichot-z-la-manchy.txt
067-miguel-de-cervantes-saavedra-don-kichot-z-la-manchy-ksiega-05-rozdzial-16.mp3	don-kichot-z-la-manchy.txt
068-miguel-de-cervantes-saavedra-don-kichot-z-la-manchy-ksiega-05-rozdzial-17.mp3	don-kichot-z-la-manchy.txt
069-miguel-de-cervantes-saavedra-don-kichot-z-la-manchy-ksiega-06-rozdzial-01.mp3	don-kichot-z-la-manchy.txt
070-miguel-de-cervantes-saavedra-don-kichot-z-la-manchy-ksiega-06-rozdzial-02.mp3	don-kichot-z-la-manchy.txt
071-miguel-de-cervantes-saavedra-don-kichot-z-la-manchy-ksiega-06-rozdzial-03.mp3	don-kichot-z-la-manchy.txt
072-miguel-de-cervantes-saavedra-don-kichot-z-la-manchy-ksiega-06-rozdzial-04.mp3	don-kichot-z-la-manchy.txt
073-miguel-de-cervantes-saavedra-don-kichot-z-la-manchy-ksiega-06-rozdzial-05.mp3	don-kichot-z-la-manchy.txt
074-miguel-de-cervantes-saavedra-don-kichot-z-la-manchy-ksiega-06-rozdzial-06.mp3	don-kichot-z-la-manchy.txt
075-miguel-de-cervantes-saavedra-don-kichot-z-la-manchy-ksiega-06-rozdzial-07.mp3	don-kichot-z-la-manchy.txt
076-miguel-de-cervantes-saavedra-don-kichot-z-la-manchy-ksiega-06-rozdzial-08.mp3	don-kichot-z-la-manchy.txt
077-miguel-de-cervantes-saavedra-don-kichot-z-la-manchy-ksiega-06-rozdzial-09.mp3	don-kichot-z-la-manchy.txt
078-miguel-de-cervantes-saavedra-don-kichot-z-la-manchy-ksiega-06-rozdzial-10.mp3	don-kichot-z-la-manchy.txt
079-miguel-de-cervantes-saavedra-don-kichot-z-la-manchy-ksiega-06-rozdzial-11.mp3	don-kichot-z-la-manchy.txt
080-miguel-de-cervantes-saavedra-don-kichot-z-la-manchy-ksiega-06-rozdzial-12.mp3	don-kichot-z-la-manchy.txt
081-miguel-de-cervantes-saavedra-don-kichot-z-la-manchy-ksiega-06-rozdzial-13.mp3	don-kichot-z-la-manchy.txt
082-miguel-de-cervantes-saavedra-don-kichot-z-la-manchy-ksiega-06-rozdzial-14.mp3	don-kichot-z-la-manchy.txt
083-miguel-de-cervantes-saavedra-don-kichot-z-la-manchy-ksiega-06-rozdzial-15.mp3	don-kichot-z-la-manchy.txt
084-miguel-de-cervantes-saavedra-don-kichot-z-la-manchy-ksiega-07-rozdzial-01.mp3	don-kichot-z-la-manchy.txt
085-miguel-de-cervantes-saavedra-don-kichot-z-la-manchy-ksiega-07-rozdzial-02.mp3	don-kichot-z-la-manchy.txt
086-miguel-de-cervantes-saavedra-don-kichot-z-la-manchy-ksiega-07-rozdzial-03.mp3	don-kichot-z-la-manchy.txt
087-miguel-de-cervantes-saavedra-don-kichot-z-la-manchy-ksiega-07-rozdzial-04.mp3	don-kichot-z-la-manchy.txt
088-miguel-de-cervantes-saavedra-don-kichot-z-la-manchy-ksiega-07-rozdzial-05.mp3	don-kichot-z-la-manchy.txt
089-miguel-de-cervantes-saavedra-don-kichot-z-la-manchy-ksiega-07-rozdzial-06.mp3	don-kichot-z-la-manchy.txt
090-miguel-de-cervantes-saavedra-don-kichot-z-la-manchy-ksiega-07-rozdzial-07.mp3	don-kichot-z-la-manchy.txt
091-miguel-de-cervantes-saavedra-don-kichot-z-la-manchy-ksiega-07-rozdzial-08.mp3	don-kichot-z-la-manchy.txt
092-miguel-de-cervantes-saavedra-don-kichot-z-la-manchy-ksiega-07-rozdzial-09.mp3	don-kichot-z-la-manchy.txt
093-miguel-de-cervantes-saavedra-don-kichot-z-la-manchy-ksiega-07-rozdzial-10.mp3	don-kichot-z-la-manchy.txt
094-miguel-de-cervantes-saavedra-don-kichot-z-la-manchy-ksiega-07-rozdzial-11.mp3	don-kichot-z-la-manchy.txt
095-miguel-de-cervantes-saavedra-don-kichot-z-la-manchy-ksiega-07-rozdzial-12.mp3	don-kichot-z-la-manchy.txt
096-miguel-de-cervantes-saavedra-don-kichot-z-la-manchy-ksiega-07-rozdzial-13.mp3	don-kichot-z-la-manchy.txt
097-miguel-de-cervantes-saavedra-don-kichot-z-la-manchy-ksiega-07-rozdzial-14.mp3	don-kichot-z-la-manchy.txt
098-miguel-de-cervantes-saavedra-don-kichot-z-la-manchy-ksiega-07-rozdzial-15.mp3	don-kichot-z-la-manchy.txt
099-miguel-de-cervantes-saavedra-don-kichot-z-la-manchy-ksiega-07-rozdzial-16.mp3	don-kichot-z-la-manchy.txt
100-miguel-de-cervantes-saavedra-don-kichot-z-la-manchy-ksiega-07-rozdzial-17.mp3	don-kichot-z-la-manchy.txt
101-miguel-de-cervantes-saavedra-don-kichot-z-la-manchy-ksiega-07-rozdzial-18.mp3	don-kichot-z-la-manchy.txt
102-miguel-de-cervantes-saavedra-don-kichot-z-la-manchy-ksiega-07-rozdzial-19.mp3	don-kichot-z-la-manchy.txt
103-miguel-de-cervantes-saavedra-don-kichot-z-la-manchy-ksiega-07-rozdzial-20.mp3	don-kichot-z-la-manchy.txt
104-miguel-de-cervantes-saavedra-don-kichot-z-la-manchy-ksiega-08-rozdzial-01.mp3	don-kichot-z-la-manchy.txt
105-miguel-de-cervantes-saavedra-don-kichot-z-la-manchy-ksiega-08-rozdzial-02.mp3	don-kichot-z-la-manchy.txt
106-miguel-de-cervantes-saavedra-don-kichot-z-la-manchy-ksiega-08-rozdzial-03.mp3	don-kichot-z-la-manchy.txt
107-miguel-de-cervantes-saavedra-don-kichot-z-la-manchy-ksiega-08-rozdzial-04.mp3	don-kichot-z-la-manchy.txt
108-miguel-de-cervantes-saavedra-don-kichot-z-la-manchy-ksiega-08-rozdzial-05.mp3	don-kichot-z-la-manchy.txt
109-miguel-de-cervantes-saavedra-don-kichot-z-la-manchy-ksiega-08-rozdzial-06.mp3	don-kichot-z-la-manchy.txt
110-miguel-de-cervantes-saavedra-don-kichot-z-la-manchy-ksiega-08-rozdzial-07.mp3	don-kichot-z-la-manchy.txt
111-miguel-de-cervantes-saavedra-don-kichot-z-la-manchy-ksiega-08-rozdzial-08.mp3	don-kichot-z-la-manchy.txt
112-miguel-de-cervantes-saavedra-don-kichot-z-la-manchy-ksiega-08-rozdzial-09.mp3	don-kichot-z-la-manchy.txt
113-miguel-de-cervantes-saavedra-don-kichot-z-la-manchy-ksiega-08-rozdzial-10.mp3	don-kichot-z-la-manchy.txt
114-miguel-de-cervantes-saavedra-don-kichot-z-la-manchy-ksiega-08-rozdzial-11.mp3	don-kichot-z-la-manchy.txt
115-miguel-de-cervantes-saavedra-don-kichot-z-la-manchy-ksiega-08-rozdzial-12.mp3	don-kichot-z-la-manchy.txt
116-miguel-de-cervantes-saavedra-don-kichot-z-la-manchy-ksiega-08-rozdzial-13.mp3	don-kichot-z-la-manchy.txt
117-miguel-de-cervantes-saavedra-don-kichot-z-la-manchy-ksiega-08-rozdzial-14.mp3	don-kichot-z-la-manchy.txt
118-miguel-de-cervantes-saavedra-don-kichot-z-la-manchy-ksiega-08-rozdzial-15.mp3	don-kichot-z-la-manchy.txt
119-miguel-de-cervantes-saavedra-don-kichot-z-la-manchy-ksiega-08-rozdzial-16.mp3	don-kichot-z-la-manchy.txt
120-miguel-de-cervantes-saavedra-don-kichot-z-la-manchy-ksiega-08-rozdzial-17.mp3	don-kichot-z-la-manchy.txt
121-miguel-de-cervantes-saavedra-don-kichot-z-la-manchy-ksiega-08-rozdzial-18.mp3	don-kichot-z-la-manchy.txt
122-miguel-de-cervantes-saavedra-don-kichot-z-la-manchy-ksiega-08-rozdzial-19.mp3	don-kichot-z-la-manchy.txt
123-miguel-de-cervantes-saavedra-don-kichot-z-la-manchy-ksiega-08-rozdzial-20.mp3	don-kichot-z-la-manchy.txt
124-miguel-de-cervantes-saavedra-don-kichot-z-la-manchy-ksiega-08-rozdzial-21.mp3	don-kichot-z-la-manchy.txt
jan-andrzej-morsztyn-do-swoich-ksiazek-dokad-sie-moja-lutni-napierasz-skwapliwie.mp3	do-swoich-ksiazek-dokad-sie-moja-lutni-napierasz-skwapliwie.txt
jan-andrzej-morsztyn-do-swoich-ksiazek-hola-juz-dosyc-dosyc-moja-ksiego.mp3	do-swoich-ksiazek-hola-juz-dosyc-dosyc-moja-ksiego.txt
jan-andrzej-morsztyn-do-trupa.mp3	do-trupa.txt
anton-czechow-dramat.mp3	dramat.txt
ignacy-krasicki-bajki-i-przypowiesci-drzewo.mp3	drzewo.txt
jacob-i-wilhelm-grimm-duch-we-flaszce.mp3	duch-we-flaszce.txt
boleslaw-lesmian-dusiolek.mp3	dusiolek.txt
ignacy-krasicki-bajki-i-przypowiesci-dwa-psy.mp3	dwa-psy.txt
maria-konopnicka-dym.mp3	dym.txt
anton-czechow-dyrektor-pod-kanapa.mp3	dyrektor-pod-kanapa.txt
ignacy-krasicki-bajki-i-przypowiesci-dziecie-i-ojciec.mp3	dziecie-i-ojciec.txt
anton-czechow-dzielo-sztuki.mp3	dzielo-sztuki.txt
jozef-czechowicz-dzien-jak-co-dzien-tomik-zapowiedz.mp3	dzien-jak-co-dzien-zapowiedz.txt
jacob-i-wilhelm-grimm-dziewczynka-i-lalka.mp3	dziewczynka-i-lalka.txt
hans-christian-andersen-dziewczynka-z-zapalkami.mp3	dziewczynka-z-zapalkami.txt
autor-nieznany-dzisiaj-w-betlejem.mp3	dzisiaj-w-betlejem.txt
ignacy-krasicki-bajki-i-przypowiesci-dzwon.mp3	dzwon.txt
hans-christian-andersen-dzwony.mp3	dzwony.txt
ignacy-krasicki-bajki-i-przypowiesci-fialek-i-trawa.mp3	fialek-i-trawa.txt
ignacy-krasicki-bajki-i-przypowiesci-filozof.mp3	filozof.txt
ignacy-krasicki-bajki-i-przypowiesci-filozof-i-orator.mp3	filozof-i-orator.txt
cyprian-kamil-norwid-fortepian-chopina.mp3	fortepian-chopina.txt
jan-kochanowski-fragmenta-albo-pozostale-pisma-piesn-czego-chcesz-od-nas-panie-za-twe-hojne-dary.mp3	fragmenta-piesn-czego-chcesz-od-nas-panie.txt
jan-kochanowski-fraszki-ksiegi-pierwsze-do-gospodyniej.mp3	fraszki-ksiegi-pierwsze-do-gospodyniej.txt
jan-kochanowski-fraszki-ksiegi-pierwsze-do-milosci-chyba-w-serce-milosci-prosze-nie.mp3	fraszki-ksiegi-pierwsze-do-milosci-chyba-w-serce-milosci-pro.txt
jan-kochanowski-fraszki-ksiegi-pierwsze-drugie-temuz-hiszpany-wlochy-i-niemce-zwied.mp3	fraszki-ksiegi-pierwsze-drugie-temuz-hiszpany-wlochy-i-niemc.txt
jan-kochanowski-fraszki-ksiegi-pierwsze-epitafium-dziecieciu-bylem-ojcem-niedawno-dzis-nie-mam-nikogo.mp3	fraszki-ksiegi-pierwsze-epitafium-dziecieciu-bylem-ojcem-nie.txt
jan-kochanowski-fraszki-ksiegi-pierwsze-epitafium-jedrzejowi-zelislawskiemu.mp3	fraszki-ksiegi-pierwsze-epitafium-jedrzejowi-zelislawskiemu.txt
jan-kochanowski-fraszki-ksiegi-pierwsze-epitafium-wojciechowi-kryskiemu.mp3	fraszki-ksiegi-pierwsze-epitafium-wojciechowi-kryskiemu.txt
jan-kochanowski-fraszki-ksiegi-pierwsze-epitafium-wysockiemu.mp3	fraszki-ksiegi-pierwsze-epitafium-wysockiemu.txt
jan-kochanowski-fraszki-ksiegi-pierwsze-na-konrata.mp3	fraszki-ksiegi-pierwsze-na-konrata.txt
jan-kochanowski-fraszki-ksiegi-pierwsze-na-matusza.mp3	fraszki-ksiegi-pierwsze-na-matusza.txt
jan-kochanowski-fraszki-ksiegi-pierwsze-na-mlodosc.mp3	fraszki-ksiegi-pierwsze-na-mlodosc.txt
jan-kochanowski-fraszki-ksiegi-pierwsze-na-nabozna.mp3	fraszki-ksiegi-pierwsze-na-nabozna.txt
jan-kochanowski-fraszki-ksiegi-pierwsze-na-nieslownego.mp3	fraszki-ksiegi-pierwsze-na-nieslownego.txt
jan-kochanowski-fraszki-ksiegi-pierwsze-na-slase.mp3	fraszki-ksiegi-pierwsze-na-slase.txt
jan-kochanowski-fraszki-ksiegi-pierwsze-na-sokalskie-mogily.mp3	fraszki-ksiegi-pierwsze-na-sokalskie-mogily.txt
jan-kochanowski-fraszki-ksiegi-pierwsze-na-starosc.mp3	fraszki-ksiegi-pierwsze-na-starosc.txt
jan-kochanowski-fraszki-ksiegi-pierwsze-na-swoje-ksiegi.mp3	fraszki-ksiegi-pierwsze-na-swoje-ksiegi.txt
jan-kochanowski-fraszki-ksiegi-pierwsze-na-uczte.mp3	fraszki-ksiegi-pierwsze-na-uczte.txt
jan-kochanowski-fraszki-ksiegi-pierwsze-o-doktorze-hiszpanie.mp3	fraszki-ksiegi-pierwsze-o-doktorze-hiszpanie.txt
jan-kochanowski-fraszki-ksiegi-pierwsze-o-gospodyniej-proszono-jednej-wielkimi-pros.mp3	fraszki-ksiegi-pierwsze-o-gospodyniej-proszono-jednej-wielki.txt
jan-kochanowski-fraszki-ksiegi-pierwsze-o-milosci-prozno-uciec-prozno-sie-przed-miloscia-schronic.mp3	fraszki-ksiegi-pierwsze-o-milosci-prozno-uciec-prozno-sie-pr.txt
jan-kochanowski-fraszki-ksiegi-pierwsze-o-zywocie-ludzkim-fraszki-to-wszytko-cokolw.mp3	fraszki-ksiegi-pierwsze-o-zywocie-ludzkim-fraszki-to-wszytko.txt
jan-kochanowski-fraszki-ksiegi-pierwsze-o-zywocie-ludzkim-wieczna-mysli-ktoras-jest-dalej-niz-od-wieka.mp3	fraszki-ksiegi-pierwsze-o-zywocie-ludzkim-wieczna-mysli-ktor.txt
01-jan-kochanowski-fraszki-ksiegi-pierwsze-raki.mp3	fraszki-ksiegi-pierwsze-raki.txt
02-jan-kochanowski-fraszki-ksiegi-pierwsze-raki-na-wspak.mp3	fraszki-ksiegi-pierwsze-raki.txt
jan-kochanowski-fraszki-ksiegi-pierwsze-z-anakreonta-ciezko-kto-nie-miluje-ciezko-k.mp3	fraszki-ksiegi-pierwsze-z-anakreonta-ciezko-kto-nie-miluje-c.txt
jan-kochanowski-fraszki-ksiegi-pierwsze-z-anakreonta-kiedy-by-worek-bogatego-zlota.mp3	fraszki-ksiegi-pierwsze-z-anakreonta-kiedy-by-worek-bogatego.txt
jan-kochanowski-fraszki-ksiegi-pierwsze-za-pijanicami.mp3	fraszki-ksiegi-pierwsze-za-pijanicami.txt
jan-kochanowski-fraszki-ksiegi-trzecie-do-fraszek-fraszki-nieprzeplacone-wdzieczne-.mp3	fraszki-ksiegi-trzecie-do-fraszek-fraszki-nieprzeplacone-wdz.txt
jan-kochanowski-fraszki-ksiegi-trzecie-do-gor-i-lasow.mp3	fraszki-ksiegi-trzecie-do-gor-i-lasow.txt
jan-kochanowski-fraszki-ksiegi-trzecie-na-dom-w-czarnolesie.mp3	fraszki-ksiegi-trzecie-na-dom-w-czarnolesie.txt
jan-kochanowski-fraszki-ksiegi-wtore-do-fraszek-fraszki-za-wszeteczne-was-ludzie-po.mp3	fraszki-ksiegi-wtore-do-fraszek-fraszki-za-wszeteczne-was-lu.txt
jan-kochanowski-fraszki-ksiegi-wtore-na-lipe-gosciu-siadz-pod-mym-lisciem-a-odpoczn.mp3	fraszki-ksiegi-wtore-na-lipe-gosciu-siadz-pod-mym-lisciem-a-.txt
ignacy-krasicki-bajki-i-przypowiesci-furman-i-motyl.mp3	furman-i-motyl.txt
autor-nieznany-gdy-sie-chrystus-rodzi.mp3	gdy-sie-chrystus-rodzi.txt
autor-nieznany-gdy-sliczna-panna.mp3	gdy-sliczna-panna.txt
01-eliza-orzeszkowa-gloria-victis-tom-opowiadan-dziwna-historia.mp3	gloria-victis-dziwna-historia.txt
02-eliza-orzeszkowa-gloria-victis-tom-opowiadan-dziwna-historia.mp3	gloria-victis-dziwna-historia.txt
eliza-orzeszkowa-gloria-victis-tom-opowiadan-gloria-victis.mp3	gloria-victis-gloria-victis.txt
eliza-orzeszkowa-gloria-victis-tom-opowiadan-panna-roza.mp3	gloria-victis-panna-roza.txt
eliza-orzeszkowa-gloria-victis-tom-opowiadan-smierc-domu.mp3	gloria-victis-smierc-domu.txt
autor-nieznany-gore-gwiazda-jezusowi.mp3	gore-gwiazda-jezusowi.txt
01-stefan-grabinski-namietnosc.mp3	grabinski-namietnosc.txt
02-stefan-grabinski-namietnosc.mp3	grabinski-namietnosc.txt
03-stefan-grabinski-namietnosc.mp3	grabinski-namietnosc.txt
stefan-grabinski-projekcje.mp3	grabinski-namietnosc-projekcje.txt
stefan-grabinski-przypadek.mp3	grabinski-przypadek.txt
juliusz-slowacki-grob-agamemnona_1.mp3	grob-agamemnona.txt
ignacy-krasicki-bajki-i-przypowiesci-groch-przy-drodze.mp3	groch-przy-drodze.txt
autor-nieznany-hej-w-dzien-narodzenia.mp3	hej-w-dzien-narodzenia.txt
ignacy-krasicki-bajki-i-przypowiesci-hipokryt.mp3	hipokryt.txt
hans-christian-andersen-historia-roku.mp3	historia-roku.txt
01-antonina-domanska-historia-zoltej-cizemki-w-domu-i-w-puszczy.mp3	historia-zoltej-cizemki.txt
02-antonina-domanska-historia-zoltej-cizemki-dziwny-pielgrzym.mp3	historia-zoltej-cizemki.txt
03-antonina-domanska-historia-zoltej-cizemki-u-wilow.mp3	historia-zoltej-cizemki.txt
04-antonina-domanska-historia-zoltej-cizemki-konik-zwierzyniecki.mp3	historia-zoltej-cizemki.txt
05-antonina-domanska-historia-zoltej-cizemki-u-jana-dlugosza.mp3	historia-zoltej-cizemki.txt
06-antonina-domanska-historia-zoltej-cizemki-uczen-mistrza-wita.mp3	historia-zoltej-cizemki.txt
07-antonina-domanska-historia-zoltej-cizemki-jasiek.mp3	historia-zoltej-cizemki.txt
08-antonina-domanska-historia-zoltej-cizemki-swiety-kazimierz.mp3	historia-zoltej-cizemki.txt
09-antonina-domanska-historia-zoltej-cizemki-tajemnica-dworku-pod-cmentarzem.mp3	historia-zoltej-cizemki.txt
10-antonina-domanska-historia-zoltej-cizemki-poreba.mp3	historia-zoltej-cizemki.txt
11-antonina-domanska-historia-zoltej-cizemki-zakonczenie.mp3	historia-zoltej-cizemki.txt
01-e-t-a-hoffmann-dziadek-do-orzechow.mp3	hoffmann-dziadek-do-orzechow.txt
02-e-t-a-hoffmann-dziadek-do-orzechow.mp3	hoffmann-dziadek-do-orzechow.txt
03-e-t-a-hoffmann-dziadek-do-orzechow.mp3	hoffmann-dziadek-do-orzechow.txt
04-e-t-a-hoffmann-dziadek-do-orzechow.mp3	hoffmann-dziadek-do-orzechow.txt
05-e-t-a-hoffmann-dziadek-do-orzechow.mp3	hoffmann-dziadek-do-orzechow.txt
06-e-t-a-hoffmann-dziadek-do-orzechow.mp3	hoffmann-dziadek-do-orzechow.txt
07-e-t-a-hoffmann-dziadek-do-orzechow.mp3	hoffmann-dziadek-do-orzechow.txt
08-e-t-a-hoffmann-dziadek-do-orzechow.mp3	hoffmann-dziadek-do-orzechow.txt
09-e-t-a-hoffmann-dziadek-do-orzechow.mp3	hoffmann-dziadek-do-orzechow.txt
10-e-t-a-hoffmann-dziadek-do-orzechow.mp3	hoffmann-dziadek-do-orzechow.txt
11-e-t-a-hoffmann-dziadek-do-orzechow.mp3	hoffmann-dziadek-do-orzechow.txt
12-e-t-a-hoffmann-dziadek-do-orzechow.mp3	hoffmann-dziadek-do-orzechow.txt
13-e-t-a-hoffmann-dziadek-do-orzechow.mp3	hoffmann-dziadek-do-orzechow.txt
14-e-t-a-hoffmann-dziadek-do-orzechow.mp3	hoffmann-dziadek-do-orzechow.txt
milosz-biedrzycki-hold-dwa-sonety.mp3	hold-dwa-sonety.txt
edgar-allan-poe-hop-frog.mp3	hop-frog.txt
juliusz-slowacki-hymn-o-zachodzie-slonca-na-morzu-smutno-mi-boze.mp3	hymn-o-zachodzie-slonca-na-morzu.txt
jan-kasprowicz-hymny-dies-irae.mp3	hymny-dies-irae.txt
jan-kasprowicz-hymny-salome.mp3	hymny-salome.txt
jan-kasprowicz-hymny-swiety-boze-swiety-mocny.mp3	hymny-swiety-boze-swiety-mocny.txt
ignacy-krasicki-bajki-i-przypowiesci-jagnie-i-wilcy.mp3	jagnie-i-wilcy.txt
henryk-sienkiewicz-janko-muzykant.mp3	janko-muzykant.txt
ignacy-krasicki-bajki-i-przypowiesci-jastrzab-i-sokol.mp3	jastrzab-i-sokol.txt
jacob-i-wilhelm-grimm-jednooczka-dwuoczka-trzyoczka.mp3	jednooczka-dwuoczka-trzyoczka.txt
autor-nieznany-jezus-malusienki.mp3	jezus-malusienki.txt
ignacy-krasicki-bajki-i-przypowiesci-jowisz-i-owce.mp3	jowisz-i-owce.txt
ignacy-krasicki-bajki-i-przypowiesci-kalamarz-i-pioro.mp3	kalamarz-i-pioro.txt
anton-czechow-kameleon.mp3	kameleon.txt
jozef-czechowicz-kamien-tomik-knajpa.mp3	kamien-knajpa.txt
boleslaw-prus-kamizelka.mp3	kamizelka.txt
ignacy-krasicki-bajki-i-przypowiesci-kartownik.mp3	kartownik.txt
boleslaw-prus-katarynka_1.mp3	katarynka.txt
ignacy-krasicki-bajki-i-przypowiesci-komar-i-mucha.mp3	komar-i-mucha.txt
ignacy-krasicki-bajki-i-przypowiesci-koniec.mp3	koniec.txt
ignacy-krasicki-bajki-nowe-koniec.mp3	koniec-bajki-nowe.txt
ignacy-krasicki-bajki-i-przypowiesci-konie-i-furman.mp3	konie-i-furman.txt
jacob-i-wilhelm-grimm-kopciuszek.mp3	kopciuszek.txt
jacob-i-wilhelm-grimm-krasnoludki.mp3	krasnoludki.txt
jacob-i-wilhelm-grimm-krol-drozdobrody.mp3	krol-drozdobrody.txt
edgar-allan-poe-krol-dzumiec.mp3	krol-dzumiec.txt
ignacy-krasicki-bajki-i-przypowiesci-krol-i-pisarze.mp3	krol-i-pisarze.txt
hans-christian-andersen-krolowa-sniegu_1.mp3	krolowa-sniegu.txt
jacob-i-wilhelm-grimm-krol-zab.mp3	krol-zab.txt
ignacy-krasicki-bajki-nowe-kruk-i-lis.mp3	kruk-i-lis-bajki-nowe.txt
01-rudyard-kipling-ksiega-dzungli-i-czesc.mp3	ksiega-dzungli.txt
02-rudyard-kipling-ksiega-dzungli-biala-foka.mp3	ksiega-dzungli.txt
03-rudyard-kipling-ksiega-dzungli-riki-tiki-tawi.mp3	ksiega-dzungli.txt
04-rudyard-kipling-ksiega-dzungli-sziwa-i-konik-polny.mp3	ksiega-dzungli.txt
05-rudyard-kipling-ksiega-dzungli-tumai-przyjaciel-sloni.mp3	ksiega-dzungli.txt
ignacy-krasicki-bajki-i-przypowiesci-ksiegi.mp3	ksiegi.txt
ignacy-krasicki-bajki-i-przypowiesci-lakomy-i-zazdrosny.mp3	lakomy-i-zazdrosny.txt
01-antoni-lange-miranda.mp3	lange-miranda.txt
02-antoni-lange-miranda.mp3	lange-miranda.txt
03-antoni-lange-miranda.mp3	lange-miranda.txt
04-antoni-lange-miranda.mp3	lange-miranda.txt
05-antoni-lange-miranda.mp3	lange-miranda.txt
06-antoni-lange-miranda.mp3	lange-miranda.txt
07-antoni-lange-miranda.mp3	lange-miranda.txt
08-antoni-lange-miranda.mp3	lange-miranda.txt
09-antoni-lange-miranda.mp3	lange-miranda.txt
10-antoni-lange-miranda.mp3	lange-miranda.txt
11-antoni-lange-miranda.mp3	lange-miranda.txt
12-antoni-lange-miranda.mp3	lange-miranda.txt
antoni-lange-nowy-tarzan.mp3	lange-nowy-tarzan.txt
henryk-sienkiewicz-latarnik_2.mp3	latarnik.txt
franciszek-karpinski-laura-i-filon.mp3	laura-i-filon.txt
artur-oppman-legendy-warszawskie-bazyliszek.mp3	legendy-warszawskie-bazyliszek.txt
artur-oppman-legendy-warszawskie-syrena.mp3	legendy-warszawskie-syrena.txt
artur-oppman-legendy-warszawskie-zlota-kaczka.mp3	legendy-warszawskie-zlota-kaczka.txt
ignacy-krasicki-bajki-i-przypowiesci-lew-i-zwierzeta-ii.mp3	lew-i-zwierzeta.txt
ignacy-krasicki-bajki-i-przypowiesci-lew-pokorny.mp3	lew-pokorny.txt
ignacy-krasicki-bajki-i-przypowiesci-lis-i-osiel.mp3	lis-i-osiel.txt
ignacy-krasicki-bajki-i-przypowiesci-lis-i-wilk.mp3	lis-i-wilk.txt
ignacy-krasicki-bajki-i-przypowiesci-lis-mlody-i-stary.mp3	lis-mlody-i-stary.txt
autor-nieznany-lulajze-jezuniu.mp3	lulajze-jezuniu.txt
ignacy-krasicki-bajki-i-przypowiesci-madry-i-glupi.mp3	madry-i-glupi.txt
ignacy-krasicki-bajki-i-przypowiesci-madry-i-glupi-ii.mp3	madry-i-glupi-ii.txt
ignacy-krasicki-bajki-nowe-malarze.mp3	malarze-bajki-nowe.txt
anton-czechow-malcy.mp3	malcy.txt
jacob-i-wilhelm-grimm-mali-czarodzieje.mp3	mali-czarodzieje.txt
ignacy-krasicki-bajki-i-przypowiesci-malzenstwo.mp3	malzenstwo.txt
edgar-allan-poe-maska-smierci-szkarlatnej.mp3	maska-smierci-szkarlatnej.txt
ignacy-krasicki-bajki-i-przypowiesci-matedory.mp3	matedory.txt
autor-nieznany-medrcy-swiata.mp3	medrcy-swiata.txt
maria-konopnicka-mendel-gdanski_2.mp3	mendel-gdanski.txt
edgar-allan-poe-metzengerstein.mp3	metzengerstein.txt
adam-asnyk-miedzy-nami-nic-nie-bylo_1.mp3	miedzy-nami-nic-nie-bylo.txt
teofil-lenartowicz-mizerna-cicha.mp3	mizerna-cicha.txt
jacob-i-wilhelm-grimm-mysi-krolik-i-niedzwiedz.mp3	mysi-krolik-i-niedzwiedz.txt
ignacy-krasicki-bajki-i-przypowiesci-mysz-i-kot.mp3	mysz-i-kot.txt
jan-andrzej-morsztyn-nadgrobek-perlisi.mp3	nadgrobek-perlisi.txt
jan-andrzej-morsztyn-na-krzyzyk-na-piersiach-jednej-panny.mp3	na-krzyzyk-na-piersiach-jednej-panny.txt
boleslaw-lesmian-napoj-cienisty-postacie-cykl-akteon.mp3	napoj-cienisty-akteon.txt
boleslaw-lesmian-napoj-cienisty-postacie-cykl-aniol.mp3	napoj-cienisty-aniol.txt
boleslaw-lesmian-napoj-cienisty-postacie-cykl-balwan-ze-sniegu.mp3	napoj-cienisty-balwan-ze-sniegu.txt
boleslaw-lesmian-napoj-cienisty-powiesc-o-rozumnej-dziewczynie-cykl-brat.mp3	napoj-cienisty-brat.txt
boleslaw-lesmian-napoj-cienisty-spojrzystosc-cykl-chalupa.mp3	napoj-cienisty-chalupa.txt
boleslaw-lesmian-napoj-cienisty-w-nicosc-sniaca-sie-droga-cykl-cmentarz.mp3	napoj-cienisty-cmentarz.txt
boleslaw-lesmian-napoj-cienisty-spojrzystosc-cykl-cmy.mp3	napoj-cienisty-cmy.txt
boleslaw-lesmian-napoj-cienisty-mimochodem-cykl-cos-tam-mignelo-dalekiego.mp3	napoj-cienisty-cos-tam-mignelo-dalekiego.txt
boleslaw-lesmian-napoj-cienisty-postacie-cykl-dokola-klombu.mp3	napoj-cienisty-dokola-klombu.txt
boleslaw-lesmian-napoj-cienisty-spojrzystosc-cykl-do-siostry.mp3	napoj-cienisty-do-siostry.txt
boleslaw-lesmian-napoj-cienisty-powiesc-o-rozumnej-dziewczynie-cykl-dziewczyna.mp3	napoj-cienisty-dziewczyna.txt
boleslaw-lesmian-napoj-cienisty-postacie-cykl-jadwiga.mp3	napoj-cienisty-jadwiga.txt
boleslaw-lesmian-napoj-cienisty-postacie-cykl-kochankowie.mp3	napoj-cienisty-kochankowie.txt
boleslaw-lesmian-napoj-cienisty-postacie-cykl-kocmoluch.mp3	napoj-cienisty-kocmoluch.txt
boleslaw-lesmian-napoj-cienisty-postacie-cykl-kopciuszek.mp3	napoj-cienisty-kopciuszek.txt
boleslaw-lesmian-napoj-cienisty-postacie-cykl-lalka.mp3	napoj-cienisty-lalka.txt
boleslaw-lesmian-napoj-cienisty-postacie-cykl-ludzie.mp3	napoj-cienisty-ludzie.txt
boleslaw-lesmian-napoj-cienisty-w-chmur-odbiciu-cykl-magda.mp3	napoj-cienisty-magda.txt
boleslaw-lesmian-napoj-cienisty-postacie-cykl-marcin-swoboda.mp3	napoj-cienisty-marcin-swoboda.txt
boleslaw-lesmian-napoj-cienisty-postacie-cykl-matysek.mp3	napoj-cienisty-matysek.txt
boleslaw-lesmian-napoj-cienisty-postacie-cykl-migon-i-jawrzon.mp3	napoj-cienisty-migon-i-jawrzon.txt
boleslaw-lesmian-napoj-cienisty-spojrzystosc-cykl-modlitwa.mp3	napoj-cienisty-modlitwa.txt
boleslaw-lesmian-napoj-cienisty-mimochodem-cykl-modlmy-sie-srod-drzew.mp3	napoj-cienisty-modlmy-sie-srod-drzew.txt
boleslaw-lesmian-napoj-cienisty-powiesc-o-rozumnej-dziewczynie-cykl-nad-ranem.mp3	napoj-cienisty-nad-ranem.txt
boleslaw-lesmian-napoj-cienisty-powiesc-o-rozumnej-dziewczynie-cykl-namowa.mp3	napoj-cienisty-namowa.txt
boleslaw-lesmian-napoj-cienisty-spojrzystosc-cykl-na-poddaszu.mp3	napoj-cienisty-na-poddaszu.txt
boleslaw-lesmian-napoj-cienisty-w-chmur-odbiciu-cykl-niedziela.mp3	napoj-cienisty-niedziela.txt
boleslaw-lesmian-napoj-cienisty-spojrzystosc-cykl-niewiara.mp3	napoj-cienisty-niewiara.txt
boleslaw-lesmian-napoj-cienisty-postacie-cykl-niewidzialni.mp3	napoj-cienisty-niewidzialni.txt
boleslaw-lesmian-napoj-cienisty-powiesc-o-rozumnej-dziewczynie-cykl-niewiedza.mp3	napoj-cienisty-niewiedza.txt
boleslaw-lesmian-napoj-cienisty-spojrzystosc-cykl-noc.mp3	napoj-cienisty-noc.txt
boleslaw-lesmian-napoj-cienisty-powiesc-o-rozumnej-dziewczynie-cykl-noca.mp3	napoj-cienisty-noca.txt
boleslaw-lesmian-napoj-cienisty-w-chmur-odbiciu-cykl-pejzaz-wspolczesny.mp3	napoj-cienisty-pejzaz-wspolczesny.txt
boleslaw-lesmian-napoj-cienisty-postacie-cykl-poeta.mp3	napoj-cienisty-poeta.txt
boleslaw-lesmian-napoj-cienisty-powiesc-o-rozumnej-dziewczynie-cykl-tamten.mp3	napoj-cienisty-tamten.txt
boleslaw-lesmian-napoj-cienisty-spojrzystosc-cykl-trupiegi.mp3	napoj-cienisty-trupiegi.txt
boleslaw-lesmian-napoj-cienisty-w-nicosc-sniaca-sie-droga-cykl-ubostwo.mp3	napoj-cienisty-ubostwo.txt
boleslaw-lesmian-napoj-cienisty-postacie-cykl-urszula-kochanowska.mp3	napoj-cienisty-urszula-kochanowska.txt
boleslaw-lesmian-napoj-cienisty-mimochodem-cykl-uwiedly-sad.mp3	napoj-cienisty-uwiedly-sad.txt
boleslaw-lesmian-napoj-cienisty-w-chmur-odbiciu-cykl-w-chmur-odbiciu.mp3	napoj-cienisty-w-chmur-odbiciu.txt
boleslaw-lesmian-napoj-cienisty-spojrzystosc-cykl-w-czas-zmartwychwstania.mp3	napoj-cienisty-w-czas-zmartwychwstania.txt
boleslaw-lesmian-napoj-cienisty-powiesc-o-rozumnej-dziewczynie-cykl-we-snie.mp3	napoj-cienisty-we-snie.txt
boleslaw-lesmian-napoj-cienisty-w-chmur-odbiciu-cykl-wieczor.mp3	napoj-cienisty-wieczor.txt
boleslaw-lesmian-napoj-cienisty-spojrzystosc-cykl-wiedza.mp3	napoj-cienisty-wiedza.txt
boleslaw-lesmian-napoj-cienisty-powiesc-o-rozumnej-dziewczynie-cykl-wiersz-ksiezyco.mp3	napoj-cienisty-wiersz-ksiezycowy.txt
boleslaw-lesmian-napoj-cienisty-postacie-cykl-wiosna.mp3	napoj-cienisty-wiosna.txt
boleslaw-lesmian-napoj-cienisty-spojrzystosc-cykl-wspomnienie.mp3	napoj-cienisty-wspomnienie.txt
maria-konopnicka-nasza-szkapa_1.mp3	nasza-szkapa.txt
jan-andrzej-morsztyn-na-zegarek-ciekacy.mp3	na-zegarek-ciekacy.txt
ignacy-krasicki-bajki-i-przypowiesci-niedzwiedz-i-liszka.mp3	niedzwiedz-i-liszka.txt
jan-andrzej-morsztyn-niestatek-oczy-sa-ogien-czolo-jest-zwierciadlem.mp3	niestatek-oczy-sa-ogien-czolo-jest-zwierciadlem.txt
jan-andrzej-morsztyn-niestatek-predzej-kto-wiatr-w-wor-zamknie-predzej-i-promieni.mp3	niestatek-predzej-kto-wiatr-w-wor-zamknie-predzej-i-promieni.txt
anton-czechow-nie-udalo-sie.mp3	nie-udalo-sie.txt
ignacy-krasicki-bajki-i-przypowiesci-nocni-stroze.mp3	nocni-stroze.txt
jozef-czechowicz-nuta-czlowiecza-tomik-westchnienie.mp3	nuta-czlowiecza-westchnienie.txt
jozef-czechowicz-nuta-czlowiecza-tomik-zal.mp3	nuta-czlowiecza-zal.txt
platon-obrona-sokratesa.mp3	obrona-sokratesa.txt
ignacy-krasicki-bajki-i-przypowiesci-ocean-i-tagus-rzeka.mp3	ocean-i-tagus-rzeka.txt
adam-mickiewicz-oda-do-mlodosci.mp3	oda-do-mlodosci.txt
01-honore-de-balzac-ojciec-goriot.mp3	ojciec-goriot.txt
02-honore-de-balzac-ojciec-goriot.mp3	ojciec-goriot.txt
03-honore-de-balzac-ojciec-goriot.mp3	ojciec-goriot.txt
04-honore-de-balzac-ojciec-goriot.mp3	ojciec-goriot.txt
05-honore-de-balzac-ojciec-goriot.mp3	ojciec-goriot.txt
06-honore-de-balzac-ojciec-goriot.mp3	ojciec-goriot.txt
07-honore-de-balzac-ojciec-goriot.mp3	ojciec-goriot.txt
08-honore-de-balzac-ojciec-goriot.mp3	ojciec-goriot.txt
09-honore-de-balzac-ojciec-goriot.mp3	ojciec-goriot.txt
10-honore-de-balzac-ojciec-goriot.mp3	ojciec-goriot.txt
11-honore-de-balzac-ojciec-goriot.mp3	ojciec-goriot.txt
ignacy-krasicki-bajki-i-przypowiesci-ojciec-lakomy.mp3	ojciec-lakomy.txt
autor-nieznany-oj-maluski-maluski.mp3	oj-maluski-maluski.txt
artur-oppman-o-jasiu-dreczycielu-o-joziu-gapicielu-o-cesi-cmokosi-i-o-spalonej-zosi-historya-o-nieznosnym-jasiu.mp3	oppman-historya-o-nieznosnym-jasiu.txt
artur-oppman-o-jasiu-dreczycielu-o-joziu-gapicielu-o-cesi-cmokosi-i-o-spalonej-zosi-historya-stefanka-co-niechcial-jesc-obiadu.mp3	oppman-historya-stefanka-co-niechcial-jesc-obiadu.txt
artur-oppman-kot-w-butach.mp3	oppman-kot-w-butach.txt
artur-oppman-o-jasiu-dreczycielu-o-joziu-gapicielu-o-cesi-cmokosi-i-o-spalonej-zosi-napowietrzna-podroz-frania-prozniaka.mp3	oppman-napowietrzna-podroz-frania-prozniaka.txt
artur-oppman-o-jasiu-dreczycielu-o-joziu-gapicielu-o-cesi-cmokosi-i-o-spalonej-zosi-o-cesi-co-ssala-paluszek-i-o-krawcu-z-nozycami.mp3	oppman-o-cesi-co-ssala-paluszek-i-o-krawcu-z-nozycam.txt
artur-oppman-o-jasiu-dreczycielu-o-joziu-gapicielu-o-cesi-cmokosi-i-o-spalonej-zosi-o-joziu-gapicielu.mp3	oppman-o-joziu-gapicielu.txt
artur-oppman-o-jasiu-dreczycielu-o-joziu-gapicielu-o-cesi-cmokosi-i-o-spalonej-zosi-okropna-przygoda-zosi-co-sie-zapalkami-bawila.mp3	oppman-okropna-przygoda-zosi-co-sie-zapalkami-bawila.txt
artur-oppman-o-jasiu-dreczycielu-o-joziu-gapicielu-o-cesi-cmokosi-i-o-spalonej-zosi-o-panu-krecickim-i-o-smutnym-jego-wypadku.mp3	oppman-o-panu-krecickim-i-o-smutnym-jego-wypadku.txt
ignacy-krasicki-bajki-i-przypowiesci-oracze-i-jowisz.mp3	oracze-i-jowisz.txt
anton-czechow-order.mp3	order.txt
ignacy-krasicki-bajki-i-przypowiesci-orzel-i-jastrzab.mp3	orzel-i-jastrzab.txt
ignacy-krasicki-bajki-i-przypowiesci-orzel-i-sowa.mp3	orzel-i-sowa.txt
ignacy-krasicki-bajki-i-przypowiesci-osiel-i-baran.mp3	osiel-i-baran.txt
ignacy-krasicki-bajki-i-przypowiesci-osiel-i-wol.mp3	osiel-i-wol.txt
ignacy-krasicki-bajki-i-przypowiesci-owieczka-i-pasterz.mp3	owieczka-i-pasterz.txt
jacob-i-wilhelm-grimm-pan-grubas.mp3	pan-grubas.txt
ignacy-krasicki-bajki-i-przypowiesci-pan-i-kotka.mp3	pan-i-kotka.txt
ignacy-krasicki-bajki-i-przypowiesci-pan-i-pies.mp3	pan-i-pies.txt
01-adam-mickiewicz-pan-tadeusz-czyli-ostatni-zajazd-na-litwie-ksiega-i.mp3	pan-tadeusz.txt
02-adam-mickiewicz-pan-tadeusz-czyli-ostatni-zajazd-na-litwie-ksiega-ii.mp3	pan-tadeusz.txt
03-adam-mickiewicz-pan-tadeusz-czyli-ostatni-zajazd-na-litwie-ksiega-iii.mp3	pan-tadeusz.txt
04-adam-mickiewicz-pan-tadeusz-czyli-ostatni-zajazd-na-litwie-ksiega-iv.mp3	pan-tadeusz.txt
05-adam-mickiewicz-pan-tadeusz-czyli-ostatni-zajazd-na-litwie-ksiega-v.mp3	pan-tadeusz.txt
06-adam-mickiewicz-pan-tadeusz-czyli-ostatni-zajazd-na-litwie-ksiega-vi.mp3	pan-tadeusz.txt
07-adam-mickiewicz-pan-tadeusz-czyli-ostatni-zajazd-na-litwie-ksiega-vii.mp3	pan-tadeusz.txt
08-adam-mickiewicz-pan-tadeusz-czyli-ostatni-zajazd-na-litwie-ksiega-viii.mp3	pan-tadeusz.txt
09-adam-mickiewicz-pan-tadeusz-czyli-ostatni-zajazd-na-litwie-ksiega-ix.mp3	pan-tadeusz.txt
10-adam-mickiewicz-pan-tadeusz-czyli-ostatni-zajazd-na-litwie-ksiega-x.mp3	pan-tadeusz.txt
11-adam-mickiewicz-pan-tadeusz-czyli-ostatni-zajazd-na-litwie-ksiega-xi.mp3	pan-tadeusz.txt
12-adam-mickiewicz-pan-tadeusz-czyli-ostatni-zajazd-na-litwie-ksiega-xii.mp3	pan-tadeusz.txt
ignacy-krasicki-bajki-i-przypowiesci-papuga-i-wiewiorka.mp3	papuga-i-wiewiorka.txt
jacob-i-wilhelm-grimm-pastuszek.mp3	pastuszek.txt
jacob-i-wilhelm-grimm-pastuszka-gesi.mp3	pastuszka-gesi.txt
ignacy-krasicki-bajki-i-przypowiesci-paw-i-orzel.mp3	paw-i-orzel.txt
ignacy-krasicki-bajki-i-przypowiesci-pieniacze.mp3	pieniacze.txt
01-william-makepeace-thackeray-pierscien-i-roza.mp3	pierscien-i-roza.txt
02-william-makepeace-thackeray-pierscien-i-roza.mp3	pierscien-i-roza.txt
03-william-makepeace-thackeray-pierscien-i-roza.mp3	pierscien-i-roza.txt
04-william-makepeace-thackeray-pierscien-i-roza.mp3	pierscien-i-roza.txt
05-william-makepeace-thackeray-pierscien-i-roza.mp3	pierscien-i-roza.txt
06-william-makepeace-thackeray-pierscien-i-roza.mp3	pierscien-i-roza.txt
07-william-makepeace-thackeray-pierscien-i-roza.mp3	pierscien-i-roza.txt
08-william-makepeace-thackeray-pierscien-i-roza.mp3	pierscien-i-roza.txt
09-william-makepeace-thackeray-pierscien-i-roza.mp3	pierscien-i-roza.txt
10-william-makepeace-thackeray-pierscien-i-roza.mp3	pierscien-i-roza.txt
11-william-makepeace-thackeray-pierscien-i-roza.mp3	pierscien-i-roza.txt
12-william-makepeace-thackeray-pierscien-i-roza.mp3	pierscien-i-roza.txt
13-william-makepeace-thackeray-pierscien-i-roza.mp3	pierscien-i-roza.txt
14-william-makepeace-thackeray-pierscien-i-roza.mp3	pierscien-i-roza.txt
15-william-makepeace-thackeray-pierscien-i-roza.mp3	pierscien-i-roza.txt
16-william-makepeace-thackeray-pierscien-i-roza.mp3	pierscien-i-roza.txt
17-william-makepeace-thackeray-pierscien-i-roza.mp3	pierscien-i-roza.txt
18-william-makepeace-thackeray-pierscien-i-roza.mp3	pierscien-i-roza.txt
19-william-makepeace-thackeray-pierscien-i-roza.mp3	pierscien-i-roza.txt
jacob-i-wilhelm-grimm-pies-i-wrobel.mp3	pies-i-wrobel.txt
jan-kochanowski-piesni-ksiegi-pierwsze-piesn-ii-serce-roscie-patrzac-na-te-czasy.mp3	piesni-ksiegi-pierwsze-piesn-ii.txt
jan-kochanowski-piesni-ksiegi-pierwsze-piesn-ix-chcemy-sobie-byc-radzi.mp3	piesni-ksiegi-pierwsze-piesn-ix.txt
jan-kochanowski-piesni-ksiegi-pierwsze-piesn-x-kto-mi-dal-skrzydla-kto-mie-odzial-p.mp3	piesni-ksiegi-pierwsze-piesn-x.txt
jan-kochanowski-piesni-ksiegi-pierwsze-piesn-xi-stronisz-przede-mna-neto-nie-tykana.mp3	piesni-ksiegi-pierwsze-piesn-xi.txt
jan-kochanowski-piesni-ksiegi-pierwsze-piesn-xx-milo-szalec-kiedy-czas-po-temu.mp3	piesni-ksiegi-pierwsze-piesn-xx.txt
jan-kochanowski-piesni-ksiegi-wtore-piesn-iii-nie-wierz-fortunie-co-siedzisz-wysoko.mp3	piesni-ksiegi-wtore-piesn-iii.txt
jan-kochanowski-piesni-ksiegi-wtore-piesn-ix-nie-porzucaj-nadzieje.mp3	piesni-ksiegi-wtore-piesn-ix.txt
jan-kochanowski-piesni-ksiegi-wtore-piesn-v-wieczna-sromota-i-nienagrodzona.mp3	piesni-ksiegi-wtore-piesn-v.txt
jan-kochanowski-piesni-ksiegi-wtore-piesn-xii-nie-masz-i-po-drugi-raz-nie-masz-watp.mp3	piesni-ksiegi-wtore-piesn-xii.txt
jan-kochanowski-piesni-ksiegi-wtore-piesn-xiii-panu-dzieki-oddawajmy.mp3	piesni-ksiegi-wtore-piesn-xiii.txt
jan-kochanowski-piesni-ksiegi-wtore-piesn-xiv-wy-ktorzy-pospolita-rzecza-wladacie.mp3	piesni-ksiegi-wtore-piesn-xiv.txt
jan-kochanowski-piesni-ksiegi-wtore-piesn-xix-jest-kto-co-by-wzgardziwszy-te-doczes.mp3	piesni-ksiegi-wtore-piesn-xix.txt
jan-kochanowski-piesni-ksiegi-wtore-piesn-xxiv-niezwyklym-i-nie-leda-piorem-opatrzo.mp3	piesni-ksiegi-wtore-piesn-xxiv.txt
franciszek-karpinski-piesn-o-narodzeniu-panskim-bog-sie-rodzi.mp3	piesn-o-narodzeniu-panskim.txt
jan-kochanowski-piesn-swietojanska-o-sobotce.mp3	piesn-swietojanska-o-sobotce.txt
ignacy-krasicki-bajki-i-przypowiesci-pijak.mp3	pijak.txt
anton-czechow-po-ciemku.mp3	po-ciemku.txt
mendele-mojcher-sforim-podroze-beniamina-trzeciego.mp3	podroze-beniamina-trzeciego.txt
ignacy-krasicki-bajki-i-przypowiesci-podrozny_1.mp3	podrozny.txt
ignacy-krasicki-bajki-i-przypowiesci-podrozny-i-kaleka.mp3	podrozny-i-kaleka.txt
anton-czechow-podrzutek.mp3	podrzutek.txt
autor-nieznany-pojdzmy-wszyscy-do-stajenki.mp3	pojdzmy-wszyscy-do-stajenki.txt
ignacy-krasicki-bajki-i-przypowiesci-po-pniu-i-po-bocianie.mp3	po-pniu-i-po-bocianie.txt
edgar-allan-poe-portret-owalny.mp3	portret-owalny.txt
ignacy-krasicki-bajki-i-przypowiesci-potok-i-rzeka.mp3	potok-i-rzeka.txt
ignacy-krasicki-bajki-i-przypowiesci-potok-i-rzeka-ii.mp3	potok-i-rzeka-ii.txt
anton-czechow-potwarz.mp3	potwarz.txt
01-e-t-a-hoffmann-powiesci-fantastyczne-don-juan.mp3	powiesci-fantastyczne-don-juan.txt
02-e-t-a-hoffmann-powiesci-fantastyczne-don-juan.mp3	powiesci-fantastyczne-don-juan.txt
03-e-t-a-hoffmann-powiesci-fantastyczne-don-juan.mp3	powiesci-fantastyczne-don-juan.txt
e-t-a-hoffmann-powiesci-fantastyczne-kawaler-gluck_1.mp3	powiesci-fantastyczne-kawaler-gluck.txt
e-t-a-hoffmann-powiesci-fantastyczne-majorat.mp3	powiesci-fantastyczne-majorat.txt
e-t-a-hoffmann-powiesci-fantastyczne-narozne-okno.mp3	powiesci-fantastyczne-narozne-okno.txt
01-e-t-a-hoffmann-powiesci-fantastyczne-piaskun.mp3	powiesci-fantastyczne-piaskun.txt
02-e-t-a-hoffmann-powiesci-fantastyczne-piaskun.mp3	powiesci-fantastyczne-piaskun.txt
03-e-t-a-hoffmann-powiesci-fantastyczne-piaskun.mp3	powiesci-fantastyczne-piaskun.txt
04-e-t-a-hoffmann-powiesci-fantastyczne-piaskun.mp3	powiesci-fantastyczne-piaskun.txt
05-e-t-a-hoffmann-powiesci-fantastyczne-piaskun.mp3	powiesci-fantastyczne-piaskun.txt
06-e-t-a-hoffmann-powiesci-fantastyczne-piaskun.mp3	powiesci-fantastyczne-piaskun.txt
07-e-t-a-hoffmann-powiesci-fantastyczne-piaskun.mp3	powiesci-fantastyczne-piaskun.txt
08-e-t-a-hoffmann-powiesci-fantastyczne-piaskun.mp3	powiesci-fantastyczne-piaskun.txt
09-e-t-a-hoffmann-powiesci-fantastyczne-piaskun.mp3	powiesci-fantastyczne-piaskun.txt
01-e-t-a-hoffmann-powiesci-fantastyczne-skrzypce-z-cremony-radca-crespel.mp3	powiesci-fantastyczne-skrzypce-z-cremony.txt
02-e-t-a-hoffmann-powiesci-fantastyczne-skrzypce-z-cremony-radca-crespel.mp3	powiesci-fantastyczne-skrzypce-z-cremony.txt
03-e-t-a-hoffmann-powiesci-fantastyczne-skrzypce-z-cremony-radca-crespel.mp3	powiesci-fantastyczne-skrzypce-z-cremony.txt
04-e-t-a-hoffmann-powiesci-fantastyczne-skrzypce-z-cremony-radca-crespel.mp3	powiesci-fantastyczne-skrzypce-z-cremony.txt
05-e-t-a-hoffmann-powiesci-fantastyczne-skrzypce-z-cremony-radca-crespel.mp3	powiesci-fantastyczne-skrzypce-z-cremony.txt
e-t-a-hoffmann-powiesci-fantastyczne-slub.mp3	powiesci-fantastyczne-slub.txt
ignacy-krasicki-bajki-i-przypowiesci-prawda-satyryk-i-panegirysta.mp3	prawda-satyryk-i-panegirysta.txt
edgar-allan-poe-prawdziwy-opis-wypadku-z-p-waldemarem_2.mp3	prawdziwy-opis-wypadku-z-p-waldemarem.txt
anton-czechow-przesolil.mp3	przesolil.txt
autor-nieznany-przybiezeli-do-betlejem.mp3	przybiezeli-do-betleem.txt
ignacy-krasicki-bajki-i-przypowiesci-przyjaciel.mp3	przyjaciel.txt
ignacy-krasicki-bajki-nowe-przyjaciele.mp3	przyjaciele-bajki-nowe.txt
ignacy-krasicki-bajki-i-przypowiesci-pszczola-i-szerszen.mp3	pszczola-i-szrszen.txt
jan-andrzej-morsztyn-pszczola-w-bursztynie.mp3	pszczola-w-bursztynie.txt
ignacy-krasicki-bajki-i-przypowiesci-pszczoly-i-mrowki.mp3	pszczoly-i-mrowki.txt
ignacy-krasicki-bajki-i-przypowiesci-ptaki-i-osiel.mp3	ptaki-i-osiel.txt
ignacy-krasicki-bajki-i-przypowiesci-ptaszki-w-klatce.mp3	ptaszki-w-klatce.txt
adam-mickiewicz-reduta-ordona.mp3	reduta-ordona.txt
edgar-allan-poe-rekopis-znaleziony-w-butli.mp3	rekopis-znaleziony-w-butli.txt
ignacy-krasicki-bajki-i-przypowiesci-rolnik.mp3	rolnik.txt
jacob-i-wilhelm-grimm-rupiec-kopec.mp3	rupiec-kopec.txt
ignacy-krasicki-bajki-i-przypowiesci-rybka-mala-i-szczupak.mp3	rybka-mala-i-szczupak.txt
ignacy-krasicki-bajki-i-przypowiesci-sasiedztwo.mp3	sasiedztwo.txt
ignacy-krasicki-satyry-czesc-druga-malzenstwo.mp3	satyry-czesc-druga-malzenstwo.txt
ignacy-krasicki-satyry-czesc-druga-pochwala-glupstwa.mp3	satyry-czesc-druga-pochwala-glupstwa.txt
ignacy-krasicki-satyry-czesc-pierwsza-do-krola.mp3	satyry-czesc-pierwsza-do-krola.txt
ignacy-krasicki-satyry-czesc-pierwsza-pijanstwo.mp3	satyry-czesc-pierwsza-pijanstwo.txt
ignacy-krasicki-satyry-czesc-pierwsza-swiat-zepsuty.mp3	satyry-czesc-pierwsza-swiat-zepsuty.txt
ignacy-krasicki-satyry-czesc-pierwsza-zona-modna.mp3	satyry-czesc-pierwsza-zona-modna.txt
edgar-allan-poe-serce-oskarzycielem.mp3	serce-oskarzycielem.txt
jacob-i-wilhelm-grimm-siedmiospiochy.mp3	siedmiospiochy.txt
stefan-zeromski-silaczka.mp3	silaczka.txt
ignacy-krasicki-bajki-i-przypowiesci-skapy.mp3	skapy.txt
ignacy-krasicki-bajki-i-przypowiesci-skarb.mp3	skarb.txt
jacob-i-wilhelm-grimm-slodka-potrawa.mp3	slodka-potrawa.txt
ignacy-krasicki-bajki-i-przypowiesci-slon-i-pszczola.mp3	slon-i-pszczola.txt
ignacy-krasicki-bajki-i-przypowiesci-slowik-i-szczygiel.mp3	slowik-i-szczygiel.txt
ignacy-krasicki-bajki-i-przypowiesci-slowik-i-szczygiel-ii.mp3	slowik-i-szczygiel-ii.txt
tadeusz-boy-zelenski-slowka-zbior-ach-co-za-przesliczne-abecadlo.mp3	slowka-zbior-ach-co-za-przesliczne-abecadlo.txt
tadeusz-boy-zelenski-slowka-zbior-dziadzio.mp3	slowka-zbior-dziadzio.txt
tadeusz-boy-zelenski-slowka-zbior-dziwna-przygoda-rodziny-polanieckich.mp3	slowka-zbior-dziwna-przygoda-rodziny-polanieckich.txt
tadeusz-boy-zelenski-slowka-zbior-ernestynka.mp3	slowka-zbior-ernestynka.txt
tadeusz-boy-zelenski-slowka-zbior-franio.mp3	slowka-zbior-franio.txt
tadeusz-boy-zelenski-slowka-zbior-gdy-sie-czlowiek-robi-starszy.mp3	slowka-zbior-gdy-sie-czlowiek-robi-starszy.txt
tadeusz-boy-zelenski-slowka-zbior-jak-wyglada-niedziela.mp3	slowka-zbior-jak-wyglada-niedziela.txt
tadeusz-boy-zelenski-slowka-zbior-krakowski-jubileusz.mp3	slowka-zbior-krakowski-jubileusz.txt
tadeusz-boy-zelenski-slowka-zbior-list-otwarty-kobiety-polskiej.mp3	slowka-zbior-list-otwarty-kobiety-polskiej.txt
tadeusz-boy-zelenski-slowka-zbior-list-prywatny-do-kornela-makuszynskiego.mp3	slowka-zbior-list-prywatny-do-kornela-makuszynskiego.txt
tadeusz-boy-zelenski-slowka-zbior-litania-ku-czci-p-t-matrony-krakowskiej.mp3	slowka-zbior-litania-ku-czci-p-t-matrony-krakowskiej.txt
tadeusz-boy-zelenski-slowka-zbior-naszym-hymenografomanom.mp3	slowka-zbior-naszym-hymenografomanom.txt
tadeusz-boy-zelenski-slowka-zbior-nowa-wiara.mp3	slowka-zbior-nowa-wiara.txt
tadeusz-boy-zelenski-slowka-zbior-o-bardzo-niegrzecznej-literaturze-polskiej-i-jej-_2.mp3	slowka-zbior-o-bardzo-niegrzecznej-literaturze-polskiej-i-jej-strapionej-ciotce.txt
tadeusz-boy-zelenski-slowka-zbior-odsiecz-wiednia.mp3	slowka-zbior-odsiecz-wiednia.txt
tadeusz-boy-zelenski-slowka-zbior-o-tem-co-w-polszcze-dzieyopis-miec-winien.mp3	slowka-zbior-o-tem-co-w-polszcze-dzieyopis-miec-winien.txt
tadeusz-boy-zelenski-slowka-zbior-piesn-o-mowie-naszej.mp3	slowka-zbior-piesn-o-mowie-naszej.txt
tadeusz-boy-zelenski-slowka-zbior-piosenki-zielonego-balonika-co-mowili-w-kosciele-u-kapucynow.mp3	slowka-zbior-piosenki-zb-co-mowili-w-kosciele-u-kapucynow.txt
tadeusz-boy-zelenski-slowka-zbior-piosenki-zielonego-balonika-dobra-mama.mp3	slowka-zbior-piosenki-zb-dobra-mama.txt
tadeusz-boy-zelenski-slowka-zbior-piosenki-zielonego-balonika-dzien-p-esika-w-ostendzie.mp3	slowka-zbior-piosenki-zb-dzien-p-esika-w-ostendzie.txt
tadeusz-boy-zelenski-slowka-zbior-piosenki-zielonego-balonika-glos-dziadkowy-o-restauracji-kosciola-parafialnego-w-porecinie.mp3	slowka-zbior-piosenki-zb-glos-dziadkowy-o-restauracji-kosciola-parafialnego.txt
tadeusz-boy-zelenski-slowka-zbior-piosenki-zielonego-balonika-glos-rozjemczy-w-sprawie-pana-wilhelma-feldmana-contra-rosner-zulawski-tetmajer-etc-etc.mp3	slowka-zbior-piosenki-zb-glos-rozjemczy-w-sprawie-pana-wilhelma-feldmana.txt
tadeusz-boy-zelenski-slowka-zbior-piosenki-zielonego-balonika-historia-prawicy-narodowej.mp3	slowka-zbior-piosenki-zb-historia-prawicy-narodowej.txt
tadeusz-boy-zelenski-slowka-zbior-piosenki-zielonego-balonika-joie-de-vivre.mp3	slowka-zbior-piosenki-zb-joie-de-vivre.txt
tadeusz-boy-zelenski-slowka-zbior-piosenki-zielonego-balonika-kilka-slow-o-piosence.mp3	slowka-zbior-piosenki-zb-kilka-slow-o-piosence.txt
tadeusz-boy-zelenski-slowka-zbior-piosenki-zielonego-balonika-kilka-slow-w-obronie-swietosci-malzenstwa.mp3	slowka-zbior-piosenki-zb-kilka-slow-w-obronie-swietosci-malzenstwa.txt
tadeusz-boy-zelenski-slowka-zbior-piosenki-zielonego-balonika-kuplet-posla-battaglii.mp3	slowka-zbior-piosenki-zb-kuplet-posla-battaglii.txt
tadeusz-boy-zelenski-slowka-zbior-piosenki-zielonego-balonika-mistrzowi-styce.mp3	slowka-zbior-piosenki-zb-mistrzowi-styce.txt
tadeusz-boy-zelenski-slowka-zbior-piosenki-zielonego-balonika-nowa-piesn-o-rydzu.mp3	slowka-zbior-piosenki-zb-nowa-piesn-o-rydzu.txt
tadeusz-boy-zelenski-slowka-zbior-piosenki-zielonego-balonika-opowiesc-dziadkowa-o-cudach-jasnogorskich.mp3	slowka-zbior-piosenki-zb-opowiesc-dziadkowa-o-cudach-jasnogorskich.txt
tadeusz-boy-zelenski-slowka-zbior-piosenki-zielonego-balonika-opowiesc-dziadkowa-o-cudach-rapperswylskich.mp3	slowka-zbior-piosenki-zb-opowiesc-dziadkowa-o-cudach-rapperswylskich.txt
tadeusz-boy-zelenski-slowka-zbior-piosenki-zielonego-balonika-opowiesc-dziadkowa-o-zaginionej-hrabinie.mp3	slowka-zbior-piosenki-zb-opowiesc-dziadkowa-o-zaginionej-hrabinie.txt
tadeusz-boy-zelenski-slowka-zbior-piosenki-zielonego-balonika-piesn-o-domu-malarskim.mp3	slowka-zbior-piosenki-zb-piesn-o-domu-malarskim.txt
tadeusz-boy-zelenski-slowka-zbior-piosenki-zielonego-balonika-piesn-o-lwowskim-rafaelu.mp3	slowka-zbior-piosenki-zb-piesn-o-lwowskim-rafaelu.txt
tadeusz-boy-zelenski-slowka-zbior-piosenki-zielonego-balonika-piesn-o-naszych-stolicach-i-jak-je-opatrznosc-obdzielila.mp3	slowka-zbior-piosenki-zb-piesn-o-naszych-stolicach-i-jak-je-opatrznosc-obdzielila.txt
tadeusz-boy-zelenski-slowka-zbior-piosenki-zielonego-balonika-piesn-o-stu-koronach.mp3	slowka-zbior-piosenki-zb-piesn-o-stu-koronach.txt
tadeusz-boy-zelenski-slowka-zbior-piosenki-zielonego-balonika-piosenka-sentymentalna-ktorej-jednak-nie-trzeba-brac-zanadto-serio.mp3	slowka-zbior-piosenki-zb-piosenka-sentymentalna.txt
tadeusz-boy-zelenski-slowka-zbior-piosenki-zielonego-balonika-piosenka-w-stylu-klasycznym.mp3	slowka-zbior-piosenki-zb-piosenka-w-stylu-klasycznym.txt
tadeusz-boy-zelenski-slowka-zbior-piosenki-zielonego-balonika-piosenka-wzruszajaca.mp3	slowka-zbior-piosenki-zb-piosenka-wzruszajaca.txt
tadeusz-boy-zelenski-slowka-zbior-piosenki-zielonego-balonika-pobudka.mp3	slowka-zbior-piosenki-zb-pobudka.txt
tadeusz-boy-zelenski-slowka-zbior-piosenki-zielonego-balonika-pochwala-ojcostwa.mp3	slowka-zbior-piosenki-zb-pochwala-ojcostwa.txt
tadeusz-boy-zelenski-slowka-zbior-piosenki-zielonego-balonika-pozegnanie.mp3	slowka-zbior-piosenki-zb-pozegnanie.txt
tadeusz-boy-zelenski-slowka-zbior-piosenki-zielonego-balonika-proroctwo-krolowej-jadwigi.mp3	slowka-zbior-piosenki-zb-proroctwo-krolowej-jadwigi.txt
tadeusz-boy-zelenski-slowka-zbior-piosenki-zielonego-balonika-wiersz-inauguracyjny-na-otwarcie-piatego-sezonu-zielonego-balonika.mp3	slowka-zbior-piosenki-zb-wiersz-inauguracyjny.txt
tadeusz-boy-zelenski-slowka-zbior-piosenki-zielonego-balonika-zielony-balonik-muzeum-narodowemu.mp3	slowka-zbior-piosenki-zb-zielony-balonik-muzeum-narodowemu.txt
tadeusz-boy-zelenski-slowka-zbior-piosenki-zielonego-balonika-z-niewydanej-szopki-krakowskiej-na-rok-1908.mp3	slowka-zbior-piosenki-zb-z-niewydanej-szopki-krakowskiej-na-rok-1908.txt
tadeusz-boy-zelenski-slowka-zbior-piosenki-zielonego-balonika-zur-hebung-des-fremdenverkehrs.mp3	slowka-zbior-piosenki-zb-zur-hebung-des-fremdenverkehrs.txt
tadeusz-boy-zelenski-slowka-zbior-pochwala-wieku-dojrzalego.mp3	slowka-zbior-pochwala-wieku-dojrzalego.txt
tadeusz-boy-zelenski-slowka-zbior-polaly-sie-lzy-me-czyste-rzesiste.mp3	slowka-zbior-polaly-sie-lzy-me-czyste-rzesiste.txt
tadeusz-boy-zelenski-slowka-zbior-replika-kobiety-polskiej.mp3	slowka-zbior-replika-kobiety-polskiej.txt
tadeusz-boy-zelenski-slowka-zbior-slowka.mp3	slowka-zbior-slowka.txt
tadeusz-boy-zelenski-slowka-zbior-spleen.mp3	slowka-zbior-spleen.txt
tadeusz-boy-zelenski-slowka-zbior-spowiedz-poety.mp3	slowka-zbior-spowiedz-poety.txt
tadeusz-boy-zelenski-slowka-zbior-stefania.mp3	slowka-zbior-stefania.txt
tadeusz-boy-zelenski-slowka-zbior-trudno-inaczej.mp3	slowka-zbior-trudno-inaczej.txt
tadeusz-boy-zelenski-slowka-zbior-w-karlsbadzie.mp3	slowka-zbior-w-karlsbadzie.txt
tadeusz-boy-zelenski-slowka-zbior-zdarzenie-prawdziwe.mp3	slowka-zbior-zdarzenie-prawdziwe.txt
tadeusz-boy-zelenski-slowka-zbior-z-nastrojow-wiosennych.mp3	slowka-zbior-z-nastrojow-wiosennych.txt
tadeusz-boy-zelenski-slowka-zbior-z-podrozy-lucjana-rydla-na-wschod.mp3	slowka-zbior-z-podrozy-lucjana-rydla-na-wschod.txt
jacob-i-wilhelm-grimm-smierc-kurki.mp3	smierc-kurki.txt
adam-mickiewicz-smierc-pulkownika.mp3	smierc-pulkownika.txt
ignacy-krasicki-bajki-i-przypowiesci-snycerz-i-statua.mp3	snycerz-i-statua.txt
mikolaj-sep-szarzynski-sonet-ii-na-one-slowa-jopowe.mp3	sonet-ii-na-one-slowa-jopowe.txt
mikolaj-sep-szarzynski-sonet-i-o-krotkosci-i-niepewnosci-na-swiecie-zywota-czlowiec.mp3	sonet-i-o-krotkosci-i-niepewnosci-na-swiecie-zywota-czlowieczego.txt
mikolaj-sep-szarzynski-sonet-iv-o-wojnie-naszej-ktora-wiedziemy-z-szatanem-swiatem-.mp3	sonet-iv-o-wojnie-naszej-ktora-wiedziemy-z-szatanem-swiatem--i-cialem.txt
mikolaj-sep-szarzynski-sonet-v-o-nietrwalej-milosci-rzeczy-swiata-tego.mp3	sonet-v-o-nietrwalej-milosci-rzeczy-swiata-tego.txt
adam-mickiewicz-sonety-krymskie-ajudah.mp3	sonety-krymskie-ajudah.txt
adam-mickiewicz-sonety-krymskie-aluszta-w-dzien.mp3	sonety-krymskie-aluszta-w-dzien.txt
adam-mickiewicz-sonety-krymskie-aluszta-w-nocy.mp3	sonety-krymskie-aluszta-w-nocy.txt
adam-mickiewicz-sonety-krymskie-bajdary.mp3	sonety-krymskie-bajdary.txt
adam-mickiewicz-sonety-krymskie-bakczysaraj.mp3	sonety-krymskie-bakczysaraj.txt
adam-mickiewicz-sonety-krymskie-bakczysaraj-w-nocy.mp3	sonety-krymskie-bakczysaraj-w-nocy.txt
adam-mickiewicz-sonety-krymskie-burza.mp3	sonety-krymskie-burza.txt
adam-mickiewicz-sonety-krymskie-cisza-morska.mp3	sonety-krymskie-cisza-morska.txt
adam-mickiewicz-sonety-krymskie-czatyrdah.mp3	sonety-krymskie-czatyrdah.txt
adam-mickiewicz-sonety-krymskie-droga-nad-przepascia-w-czufut-kale.mp3	sonety-krymskie-droga-nad-przepascia-w-czufut-kale.txt
adam-mickiewicz-sonety-krymskie-gora-kikineis.mp3	sonety-krymskie-gora-kikineis.txt
adam-mickiewicz-sonety-krymskie-grob-potockiej.mp3	sonety-krymskie-grob-potockiej.txt
adam-mickiewicz-sonety-krymskie-mogily-haremu.mp3	sonety-krymskie-mogily-haremu.txt
adam-mickiewicz-sonety-krymskie-sonety-krymskie-motto-i-dedykacja.mp3	sonety-krymskie-motto-i-dedykacja.txt
adam-mickiewicz-sonety-krymskie-pielgrzym.mp3	sonety-krymskie-pielgrzym.txt
adam-mickiewicz-sonety-krymskie-ruiny-zamku-w-balaklawie.mp3	sonety-krymskie-ruiny-zamku-w-balaklawie.txt
adam-mickiewicz-sonety-krymskie-stepy-akermanskie.mp3	sonety-krymskie-stepy-akermanskie.txt
adam-mickiewicz-sonety-krymskie-widok-gor-ze-stepow-kozlowa.mp3	sonety-krymskie-widok-gor-ze-stepow-kozlowa.txt
adam-mickiewicz-sonety-krymskie-zegluga.mp3	sonety-krymskie-zegluga.txt
adam-mickiewicz-sonety-odeskie-do-m.mp3	sonety-odeskie-do-m.txt
artur-oppman-spiaca-krolewna.mp3	spiaca-krolewna-oppman.txt
01-alfred-de-musset-spowiedz-dzieciecia-wieku-czesc-01-rozdzial-01.mp3	spowiedz-dzieciecia-wieku.txt
02-alfred-de-musset-spowiedz-dzieciecia-wieku-czesc-01-rozdzial-02.mp3	spowiedz-dzieciecia-wieku.txt
03-alfred-de-musset-spowiedz-dzieciecia-wieku-czesc-01-rozdzial-03.mp3	spowiedz-dzieciecia-wieku.txt
04-alfred-de-musset-spowiedz-dzieciecia-wieku-czesc-01-rozdzial-04.mp3	spowiedz-dzieciecia-wieku.txt
05-alfred-de-musset-spowiedz-dzieciecia-wieku-czesc-01-rozdzial-05.mp3	spowiedz-dzieciecia-wieku.txt
06-alfred-de-musset-spowiedz-dzieciecia-wieku-czesc-01-rozdzial-06.mp3	spowiedz-dzieciecia-wieku.txt
07-alfred-de-musset-spowiedz-dzieciecia-wieku-czesc-01-rozdzial-07.mp3	spowiedz-dzieciecia-wieku.txt
08-alfred-de-musset-spowiedz-dzieciecia-wieku-czesc-01-rozdzial-08.mp3	spowiedz-dzieciecia-wieku.txt
09-alfred-de-musset-spowiedz-dzieciecia-wieku-czesc-01-rozdzial-09.mp3	spowiedz-dzieciecia-wieku.txt
10-alfred-de-musset-spowiedz-dzieciecia-wieku-czesc-01-rozdzial-10.mp3	spowiedz-dzieciecia-wieku.txt
11-alfred-de-musset-spowiedz-dzieciecia-wieku-czesc-02-rozdzial-01.mp3	spowiedz-dzieciecia-wieku.txt
12-alfred-de-musset-spowiedz-dzieciecia-wieku-czesc-02-rozdzial-02.mp3	spowiedz-dzieciecia-wieku.txt
13-alfred-de-musset-spowiedz-dzieciecia-wieku-czesc-02-rozdzial-03.mp3	spowiedz-dzieciecia-wieku.txt
14-alfred-de-musset-spowiedz-dzieciecia-wieku-czesc-02-rozdzial-04.mp3	spowiedz-dzieciecia-wieku.txt
15-alfred-de-musset-spowiedz-dzieciecia-wieku-czesc-02-rozdzial-05.mp3	spowiedz-dzieciecia-wieku.txt
16-alfred-de-musset-spowiedz-dzieciecia-wieku-czesc-03-rozdzial-01.mp3	spowiedz-dzieciecia-wieku.txt
17-alfred-de-musset-spowiedz-dzieciecia-wieku-czesc-03-rozdzial-02.mp3	spowiedz-dzieciecia-wieku.txt
18-alfred-de-musset-spowiedz-dzieciecia-wieku-czesc-03-rozdzial-03.mp3	spowiedz-dzieciecia-wieku.txt
19-alfred-de-musset-spowiedz-dzieciecia-wieku-czesc-03-rozdzial-04.mp3	spowiedz-dzieciecia-wieku.txt
20-alfred-de-musset-spowiedz-dzieciecia-wieku-czesc-03-rozdzial-05.mp3	spowiedz-dzieciecia-wieku.txt
21-alfred-de-musset-spowiedz-dzieciecia-wieku-czesc-03-rozdzial-06.mp3	spowiedz-dzieciecia-wieku.txt
22-alfred-de-musset-spowiedz-dzieciecia-wieku-czesc-03-rozdzial-07.mp3	spowiedz-dzieciecia-wieku.txt
23-alfred-de-musset-spowiedz-dzieciecia-wieku-czesc-03-rozdzial-08.mp3	spowiedz-dzieciecia-wieku.txt
24-alfred-de-musset-spowiedz-dzieciecia-wieku-czesc-03-rozdzial-09.mp3	spowiedz-dzieciecia-wieku.txt
25-alfred-de-musset-spowiedz-dzieciecia-wieku-czesc-03-rozdzial-10.mp3	spowiedz-dzieciecia-wieku.txt
26-alfred-de-musset-spowiedz-dzieciecia-wieku-czesc-03-rozdzial-11.mp3	spowiedz-dzieciecia-wieku.txt
27-alfred-de-musset-spowiedz-dzieciecia-wieku-czesc-04-rozdzial-01.mp3	spowiedz-dzieciecia-wieku.txt
28-alfred-de-musset-spowiedz-dzieciecia-wieku-czesc-04-rozdzial-02.mp3	spowiedz-dzieciecia-wieku.txt
29-alfred-de-musset-spowiedz-dzieciecia-wieku-czesc-04-rozdzial-03.mp3	spowiedz-dzieciecia-wieku.txt
30-alfred-de-musset-spowiedz-dzieciecia-wieku-czesc-04-rozdzial-04.mp3	spowiedz-dzieciecia-wieku.txt
31-alfred-de-musset-spowiedz-dzieciecia-wieku-czesc-04-rozdzial-05.mp3	spowiedz-dzieciecia-wieku.txt
32-alfred-de-musset-spowiedz-dzieciecia-wieku-czesc-04-rozdzial-06.mp3	spowiedz-dzieciecia-wieku.txt
33-alfred-de-musset-spowiedz-dzieciecia-wieku-czesc-05-rozdzial-01.mp3	spowiedz-dzieciecia-wieku.txt
34-alfred-de-musset-spowiedz-dzieciecia-wieku-czesc-05-rozdzial-02.mp3	spowiedz-dzieciecia-wieku.txt
35-alfred-de-musset-spowiedz-dzieciecia-wieku-czesc-05-rozdzial-03.mp3	spowiedz-dzieciecia-wieku.txt
36-alfred-de-musset-spowiedz-dzieciecia-wieku-czesc-05-rozdzial-04.mp3	spowiedz-dzieciecia-wieku.txt
37-alfred-de-musset-spowiedz-dzieciecia-wieku-czesc-05-rozdzial-05.mp3	spowiedz-dzieciecia-wieku.txt
38-alfred-de-musset-spowiedz-dzieciecia-wieku-czesc-05-rozdzial-06.mp3	spowiedz-dzieciecia-wieku.txt
39-alfred-de-musset-spowiedz-dzieciecia-wieku-czesc-05-rozdzial-07.mp3	spowiedz-dzieciecia-wieku.txt
ignacy-krasicki-bajki-i-przypowiesci-stary-pies-i-stary-sluga.mp3	stary-pies-i-stary-sluga.txt
ignacy-krasicki-bajki-i-przypowiesci-strumyk-i-fontanny.mp3	strumyk-i-fontanny.txt
ignacy-krasicki-bajki-i-przypowiesci-strzelec-i-pies.mp3	strzelec-i-pies.txt
edgar-allan-poe-studnia-i-wahadlo.mp3	studnia-i-wahadlo.txt
ignacy-krasicki-bajki-i-przypowiesci-sultan-w-piekle.mp3	sultan-w-piekle.txt
boleslaw-lesmian-swidryga-i-midryga.mp3	swidryga-i-midryga.txt
ignacy-krasicki-bajki-i-przypowiesci-syn-i-ojciec.mp3	syn-i-ojciec.txt
ignacy-krasicki-bajki-i-przypowiesci-synogarlica.mp3	synogarlica.txt
anton-czechow-syrena.mp3	syrena.txt
anton-czechow-szczesliwy.mp3	szczesliwy.txt
ignacy-krasicki-bajki-i-przypowiesci-szczurek-i-matka.mp3	szczurek-i-matka.txt
ignacy-krasicki-bajki-i-przypowiesci-szczur-i-kot.mp3	szczur-i-kot.txt
ignacy-krasicki-bajki-i-przypowiesci-szkapa-i-rumak.mp3	szkapa-i-rumak.txt
ignacy-krasicki-bajki-i-przypowiesci-szkatula-ze-zlotem-wor-z-kasza.mp3	szkatula-ze-zlotem-wor-z-kasza.txt
anton-czechow-szydlo-w-worku.mp3	szydlo-w-worku.txt
ignacy-krasicki-bajki-i-przypowiesci-talar-i-czerwony-zloty.mp3	talar-czerwony-i-zloty.txt
juliusz-slowacki-testament-moj_1.mp3	testament-moj.txt
jan-kochanowski-epitafium-hannie-kochanowskiej.mp3	treny-epitafium-hannie-kochanowskiej.txt
jan-kochanowski-treny-treny-motto-i-dedykacja.mp3	treny-motto-i-dedykacja.txt
jan-kochanowski-treny-tren-i.mp3	treny-tren-i.txt
jan-kochanowski-treny-tren-ii.mp3	treny-tren-ii.txt
jan-kochanowski-treny-tren-iii.mp3	treny-tren-iii.txt
jan-kochanowski-treny-tren-iv.mp3	treny-tren-iv.txt
jan-kochanowski-treny-tren-ix.mp3	treny-tren-ix.txt
jan-kochanowski-treny-tren-v.mp3	treny-tren-v.txt
jan-kochanowski-treny-tren-vi.mp3	treny-tren-vi.txt
jan-kochanowski-treny-tren-vii.mp3	treny-tren-vii.txt
jan-kochanowski-treny-tren-viii.mp3	treny-tren-viii.txt
jan-kochanowski-treny-tren-x.mp3	treny-tren-x.txt
jan-kochanowski-treny-tren-xi.mp3	treny-tren-xi.txt
jan-kochanowski-treny-tren-xii.mp3	treny-tren-xii.txt
jan-kochanowski-treny-tren-xiii.mp3	treny-tren-xiii.txt
jan-kochanowski-treny-tren-xiv.mp3	treny-tren-xiv.txt
jan-kochanowski-treny-tren-xix-albo-sen.mp3	treny-tren-xix-albo-sen.txt
jan-kochanowski-treny-tren-xv.mp3	treny-tren-xv.txt
jan-kochanowski-treny-tren-xvi.mp3	treny-tren-xvi.txt
jan-kochanowski-treny-tren-xvii.mp3	treny-tren-xvii.txt
jan-kochanowski-treny-tren-xviii.mp3	treny-tren-xviii.txt
ignacy-krasicki-bajki-i-przypowiesci-trzcina-i-chmiel.mp3	trzcina-i-chmiel.txt
jacob-i-wilhelm-grimm-trzej-bracia.mp3	trzej-bracia.txt
jacob-i-wilhelm-grimm-trzy-piora.mp3	trzy-piora.txt
ignacy-krasicki-bajki-i-przypowiesci-tulipan-i-fialek.mp3	tulipan-i-fialek.txt
jacob-i-wilhelm-grimm-ubogi-bogaty.mp3	ubogi-bogaty.txt
jacob-i-wilhelm-grimm-ukradziony-grosik.mp3	ukradziony-grosik.txt
anton-czechow-wanka.mp3	wanka.txt
jacob-i-wilhelm-grimm-wilk-i-czlowiek.mp3	wilk-i-czlowiek.txt
ignacy-krasicki-bajki-i-przypowiesci-wilk-i-owce.mp3	wilk-i-owce.txt
ignacy-krasicki-bajki-i-przypowiesci-wilk-i-owce-ii.mp3	wilk-i-owce-ii.txt
ignacy-krasicki-bajki-i-przypowiesci-wilk-pokutujacy.mp3	wilk-pokutujacy.txt
edgar-allan-poe-william-wilson.mp3	william-wilson.txt
ignacy-krasicki-bajki-i-przypowiesci-wino-i-woda.mp3	wino-i-woda.txt
jacob-i-wilhelm-grimm-wloczegi.mp3	wloczegi.txt
boleslaw-lesmian-w-malinowym-chrusniaku_1.mp3	w-malinowym-chrusniaku.txt
ignacy-krasicki-bajki-i-przypowiesci-wol-i-mrowki.mp3	wol-i-mrowki.txt
ignacy-krasicki-bajki-i-przypowiesci-wol-minister.mp3	wol-minister.txt
ignacy-krasicki-bajki-i-przypowiesci-woly-krnabrne.mp3	woly-krnabrne.txt
juliusz-slowacki-w-pamietniku-zofii-bobrowny_1.mp3	w-pamietniku-zofii-bobrowny.txt
01-henryk-sienkiewicz-w-pustyni-i-w-puszczy.mp3	w-pustyni-i-w-puszczy.txt
02-henryk-sienkiewicz-w-pustyni-i-w-puszczy.mp3	w-pustyni-i-w-puszczy.txt
03-henryk-sienkiewicz-w-pustyni-i-w-puszczy.mp3	w-pustyni-i-w-puszczy.txt
04-henryk-sienkiewicz-w-pustyni-i-w-puszczy.mp3	w-pustyni-i-w-puszczy.txt
05-henryk-sienkiewicz-w-pustyni-i-w-puszczy.mp3	w-pustyni-i-w-puszczy.txt
06-henryk-sienkiewicz-w-pustyni-i-w-puszczy.mp3	w-pustyni-i-w-puszczy.txt
07-henryk-sienkiewicz-w-pustyni-i-w-puszczy.mp3	w-pustyni-i-w-puszczy.txt
08-henryk-sienkiewicz-w-pustyni-i-w-puszczy.mp3	w-pustyni-i-w-puszczy.txt
09-henryk-sienkiewicz-w-pustyni-i-w-puszczy.mp3	w-pustyni-i-w-puszczy.txt
10-henryk-sienkiewicz-w-pustyni-i-w-puszczy.mp3	w-pustyni-i-w-puszczy.txt
11-henryk-sienkiewicz-w-pustyni-i-w-puszczy.mp3	w-pustyni-i-w-puszczy.txt
12-henryk-sienkiewicz-w-pustyni-i-w-puszczy.mp3	w-pustyni-i-w-puszczy.txt
13-henryk-sienkiewicz-w-pustyni-i-w-puszczy.mp3	w-pustyni-i-w-puszczy.txt
14-henryk-sienkiewicz-w-pustyni-i-w-puszczy.mp3	w-pustyni-i-w-puszczy.txt
15-henryk-sienkiewicz-w-pustyni-i-w-puszczy.mp3	w-pustyni-i-w-puszczy.txt
16-henryk-sienkiewicz-w-pustyni-i-w-puszczy.mp3	w-pustyni-i-w-puszczy.txt
17-henryk-sienkiewicz-w-pustyni-i-w-puszczy.mp3	w-pustyni-i-w-puszczy.txt
18-henryk-sienkiewicz-w-pustyni-i-w-puszczy.mp3	w-pustyni-i-w-puszczy.txt
19-henryk-sienkiewicz-w-pustyni-i-w-puszczy.mp3	w-pustyni-i-w-puszczy.txt
20-henryk-sienkiewicz-w-pustyni-i-w-puszczy.mp3	w-pustyni-i-w-puszczy.txt
21-henryk-sienkiewicz-w-pustyni-i-w-puszczy.mp3	w-pustyni-i-w-puszczy.txt
22-henryk-sienkiewicz-w-pustyni-i-w-puszczy.mp3	w-pustyni-i-w-puszczy.txt
23-henryk-sienkiewicz-w-pustyni-i-w-puszczy.mp3	w-pustyni-i-w-puszczy.txt
24-henryk-sienkiewicz-w-pustyni-i-w-puszczy.mp3	w-pustyni-i-w-puszczy.txt
25-henryk-sienkiewicz-w-pustyni-i-w-puszczy.mp3	w-pustyni-i-w-puszczy.txt
26-henryk-sienkiewicz-w-pustyni-i-w-puszczy.mp3	w-pustyni-i-w-puszczy.txt
27-henryk-sienkiewicz-w-pustyni-i-w-puszczy.mp3	w-pustyni-i-w-puszczy.txt
28-henryk-sienkiewicz-w-pustyni-i-w-puszczy.mp3	w-pustyni-i-w-puszczy.txt
29-henryk-sienkiewicz-w-pustyni-i-w-puszczy.mp3	w-pustyni-i-w-puszczy.txt
30-henryk-sienkiewicz-w-pustyni-i-w-puszczy.mp3	w-pustyni-i-w-puszczy.txt
31-henryk-sienkiewicz-w-pustyni-i-w-puszczy.mp3	w-pustyni-i-w-puszczy.txt
32-henryk-sienkiewicz-w-pustyni-i-w-puszczy.mp3	w-pustyni-i-w-puszczy.txt
33-henryk-sienkiewicz-w-pustyni-i-w-puszczy.mp3	w-pustyni-i-w-puszczy.txt
34-henryk-sienkiewicz-w-pustyni-i-w-puszczy.mp3	w-pustyni-i-w-puszczy.txt
35-henryk-sienkiewicz-w-pustyni-i-w-puszczy.mp3	w-pustyni-i-w-puszczy.txt
36-henryk-sienkiewicz-w-pustyni-i-w-puszczy.mp3	w-pustyni-i-w-puszczy.txt
37-henryk-sienkiewicz-w-pustyni-i-w-puszczy.mp3	w-pustyni-i-w-puszczy.txt
38-henryk-sienkiewicz-w-pustyni-i-w-puszczy.mp3	w-pustyni-i-w-puszczy.txt
39-henryk-sienkiewicz-w-pustyni-i-w-puszczy.mp3	w-pustyni-i-w-puszczy.txt
40-henryk-sienkiewicz-w-pustyni-i-w-puszczy.mp3	w-pustyni-i-w-puszczy.txt
41-henryk-sienkiewicz-w-pustyni-i-w-puszczy.mp3	w-pustyni-i-w-puszczy.txt
42-henryk-sienkiewicz-w-pustyni-i-w-puszczy.mp3	w-pustyni-i-w-puszczy.txt
43-henryk-sienkiewicz-w-pustyni-i-w-puszczy.mp3	w-pustyni-i-w-puszczy.txt
44-henryk-sienkiewicz-w-pustyni-i-w-puszczy.mp3	w-pustyni-i-w-puszczy.txt
45-henryk-sienkiewicz-w-pustyni-i-w-puszczy.mp3	w-pustyni-i-w-puszczy.txt
46-henryk-sienkiewicz-w-pustyni-i-w-puszczy.mp3	w-pustyni-i-w-puszczy.txt
47-henryk-sienkiewicz-w-pustyni-i-w-puszczy-zakonczenie.mp3	w-pustyni-i-w-puszczy.txt
anton-czechow-w-razurze.mp3	w-razurze.txt
autor-nieznany-wsrod-nocnej-ciszy.mp3	wsrod-nocnej-ciszy.txt
jacob-i-wilhelm-grimm-wszechwiedzacy-doktor.mp3	wszechwiedzacy-doktor.txt
anton-czechow-wykrzyknik.mp3	wykrzyknik.txt
ignacy-krasicki-bajki-i-przypowiesci-wyszydzajacy.mp3	wyszydzajacy.txt
autor-nieznany-w-zlobie-lezy.mp3	w-zlobie-lezy.txt
adam-asnyk-zaczarowana-krolewna_1.mp3	zaczarowana-krolewna.txt
anton-czechow-zagadkowa-natura.mp3	zagadkowa-natura.txt
edgar-allan-poe-zaglada-domu-usherow.mp3	zaglada-domu-usherow.txt
jacob-i-wilhelm-grimm-zajac-i-jez.mp3	zajac-i-jez.txt
anton-czechow-zarcik.mp3	zarcik.txt
boleslaw-prus-z-legend-dawnego-egiptu.mp3	z-legend-dawnego-egiptu.txt
anton-czechow-zloczynca.mp3	zloczynca.txt
ignacy-krasicki-bajki-i-przypowiesci-zolw-i-mysz.mp3	zolw-i-mysz.txt
ignacy-krasicki-bajki-i-przypowiesci-zrebiec-i-kon-stary.mp3	zrebiec-i-kon-stary.txt
jan-kasprowicz-z-wichrow-i-hal-z-tatr-krzak-dzikiej-rozy-w-ciemnych-smreczynach.mp3	z-wichrow-i-hal-z-tatr-krzak-dzikiej-rozy-w-ciemnych-smreczy.txt
ignacy-krasicki-bajki-i-przypowiesci-zwiersciadlo-podchlebne.mp3	zwiersciadlo-podchlebne.txt
ignacy-krasicki-bajki-i-przypowiesci-zwierzeta-i-niedzwiedz.mp3	zwierzeta-i-niedzwiedz.txt
