Adrian Wisniewski	m	AW
Adrian Wiśniewski	m	AW
Agnieszka Podsiadlik	f	AP
Aleksanda Sekuła	f	AS
Aleksandra Sekuła	f	AS
Andrzej Chyra	m	AC
Andrzej Girdwoyń	m	AG
Anna Bugajska	f	AB
Bartłomiej Kozielski	m	BK
Bartosz Mazur	m	BM
Danuta Stenka	f	DS
Gabriela Oberbek	f	GO
Grzegorz Pawlak	m	GP
Iwo Vedral	m	IV
Jacek Rozenek	m	JR
Jakub Falkowski	m	JF
Jakub Wieczorek	m	JW
Jan Dravnel	m	JD
Jan Peszek	m	JP
Jarosław Kozielski	m	JK
Joanna Domańska	f	JDO
Kamila Salwerowicz	f	KS
Kamil Dominiak	m	KD
Kamil Zięba	m	KZ
Karolina Porcari	f	KP
Karolina Warchoł	f	KW
Katarzyna Maciąg	f	KM
Katarzyna Misiewicz	f	KMI
Katarzyna Sawczuk	f	KSA
Krzysztof Skonieczny	m	KSK
Kuba Jurzyk	m	KJ
Leszek Żurek	m	LZ
Maciej Kosteczka	m	MK
Magdalena Popławska	f	MP
Magdalena Wasylik	f	MW
Marcin Kuczewski	m	MKU
Marta Rytter	f	MR
Michał Michalski	m	MM
Michał Węgrzyński	m	MWE
Natalia Piotrowska	f	NP
Paweł Paprocki	m	PP
Piotr Głowacki	m	PG
Piotr Żurawski	m	PZ
Roma Gąsiorowska	f	RG
Sylwia Banasik	f	SB
Sylwia Przetak	f	SP
Weronika Lewandowska	f	WL
Weronika Maja Lewandowska	f	WL
Wiktor Korszla	m	WK
Wiktor Korzeniewski	m	WKO
Zuzanna Gierczycka	f	ZG
