pies	/ˈpʲjɛs/
a-	/ɑː/
on	/ɔn̪/
robot	/ˈrɔbɔt̪/
aby	/ˈabɨ/
te	[t̪ɛ]
zero	[ˈz̪ɛrɔ]
one	/ˈɔn̪ɛ/
i	/i/
pseudo-	/ˈps̪ɛwd̪ɔ/
Edward	/ˈɛd̪vart̪/
os	/ˈɔs/
słownik	/ˈswɔvɲik/
ten	[t̪ɛ̃n̪]
most	/mɔst/
euro	[ˈɛwrɔ]
bank	[bãŋk]
but	[but]
radio	/ˈradjɔ/
ci	/t͡ɕi/
Angola	/aŋˈɡɔla/
Burundi	/buˈrundi/
Bhutan	/ˈbutan/
Botswana	/bɔt.sˈfana/
Botswana	/bɔt͡sˈfana/
Chile	/ˈt͡ʃilɛ/
Gabon	/ˈɡabɔn/
Ghana	/ˈɡana/
Gambia	/ˈɡambja/
Honduras	/xɔnˈduras/
Haiti	/xaˈiti/
Iran	/ˈiran/
Kiribati	/kʲiriˈbati/
Laos	/ˈlaɔs/
Liechtenstein	/ˈlixtɛnʂtajn/
Liberia	/liˈbɛrja/
Mali	/ˈmali/
Mongolia	/mɔŋˈɡɔlja/
Malta	/ˈmalta/
Malawi	/maˈlavi/
Namibia	/naˈmibja/
Niger	/ˈɲiɡɛr/
Nigeria	/ɲiˈɡɛrja/
mi	[mʲi]
standard	/ˈs̪t̪an̪d̪art̪/
Nepal	/ˈnɛpal/
Nauru	/ˈnawru/
Oman	/ˈɔman/
Panama	/paˈnama/
Peru	/ˈpɛru/
Pakistan	/paˈkʲistan/
Rwanda	/ruˈanda/
Sudan	/ˈsudan/
Senegal	/sɛˈnɛɡal/
Syria	/ˈs̪ɨrja/
Togo	/ˈt̪ɔɡɔ/
Tonga	/ˈt̪ɔŋɡa/
Uganda	/uˈɡan̪d̪a/
Zambia	/ˈz̪ambja/
Zimbabwe	/z̪imˈbabvɛ/
Barbados	/barˈbadɔs/
Benin	/ˈbɛɲin/
Vanuatu	/van̪uˈat̪u/
Uzbekistan	/uz̪bɛˈkʲis̪t̪an̪/
FIFA	/ˈfifa/
Somalia	/sɔˈmalja/
Sierra Leone	/sʲjɛrːa lɛˈɔnɛ/
Lesotho	/lɛˈsɔtɔ/
Saint Lucia	/sɛnt‿ˈluʂɛ/
Samoa	/saˈmɔa/
Grenada	/ɡrɛˈnada/
red	[rɛt]
tempo	[ˈt̪ɛ̃mpɔ]
weekend	/ˈwikɛn̪t̪/
humor	[ˈxumɔr]
zebra	/ˈzɛbra/
lama	/ˈlama/
to	/t̪ɔ/
my	/mɨ/
Korea	/kɔˈrɛa/
was	[vas̪]
car	/tsar/
pupa	[ˈpupa]
hobby	/ˈxɔb.bi/
om	/ɔm/
bal	[bal]
ban	/ban̪/
piece	[ˈpʲjɛt͡s̪ɛ]
idiom	/ˈidjɔm/
pizza	[ˈpit͡st͡sa]
galaktyka	[ɡaˈlaktɨka]
matka	[ˈmat̪ka]
dziewczynka	/d͡ʑɛfˈt͡ʂɨnka/
dziewczyna	/d͡ʑɛfˈt͡ʂɨna/
kawa	[ˈkava]
kaczka	[ˈkat͡ʂka]
kobieta	[kɔˈbʲjɛta]
długość	[ˈdwuɡɔɕt͡ɕ]
kara	/ˈkara/
siostra	/ˈɕɔstra/
fizyka	[ˈfizɨka]
matematyka	[matɛˈmatɨka]
matematyka	[matɛmaˈtɨka]
dziwka	/ˈd͡ʑifka/
książka	[ˈkʲɕɔ̃ʂka]
książeczka	[kʲɕɔ̃w̃ˈʐɛt͡ʂka]
łyżeczka	[wɨˈʐɛt͡ʂka]
łyżka	/ˈwɨʂka/
prostytutka	/prɔstɨˈtutka/
szklanka	[ˈʂklanka]
chemia	/ˈxɛmja/
magia	[ˈmaɟja]
czekolada	/t͡ʂɛkɔˈlada/
cebula	[t͡sɛˈbula]
herbata	[xɛrˈbat̪a]
cebulka	[t͡sɛˈbulka]
dyskietka	[dɨsˈkjɛtka]
zima	[ˈʑima]
klawiatura	[klavjaˈtura]
szkoła	[ˈʂkɔwa]
podłoga	[pɔˈdwɔɡa]
góra	[ˈɡura]
chłopak	[ˈxwɔpak]
budynek	[buˈdɨnɛk]
stół	[stuw]
nauczycielka	[n̪aut͡ʂɨˈt͡ɕɛlka]
nauczyciel	[nauˈt͡ʂɨt͡ɕɛl]
kwiatek	[ˈkfʲatɛk]
ściana	/ˈɕt͡ɕan̪a/
wódka	[ˈvutka]
Sydney	/ˈsɨdni/
Sydney	/ˈsɨdnɛj/
do	/dɔ/
suka	[ˈs̪uka]
mapa	/ˈmapa/
mama	/ˈmama/
er	[ɛr]
facet	[ˈfat͡sɛt]
go	[ɡɔ]
hit	/xit̪/
lit	/lit/
wolny	[ˈvɔlnɨ]
grudzień	/ˈɡrudʑɛɲ/
grudzień	[ˈɡru.d͡ʑej̃]
miesiąc	/ˈmjɛɕɔn̪t͡s̪/
spin	/s̪pin̪/
era	/ˈɛra/
by	[bɨ]
IPA	/ajpiˈɛj/
penis	/ˈpɛ.ɲis̪/
USA	/uɛsˈa/
laser	/ˈlas̪ɛr/
modem	/ˈmɔd̪ɛm/
bieg	[bʲɛk]
nit	/ɲit/
list	[lʲis̪t̪]
house	/xaws/
metal	/ˈmɛtal/
blade	/ˈbladɛ/
klub	/klup/
klimat	[ˈklʲimat]
Oceania	/ɔt͡s̪ɛˈaɲja/
bushido	[buˈɕid̪ɔ]
shogun	/ˈɕɔɡun̪/
chan	/xan̪/
bo	/bɔ/
u	[u]
z	/z/
z	/s/
stop	/ˈstɔp/
syn	/sɨn/
gram	/ɡram/
brew	[brɛf]
manga	[ˈmaŋɡa]
menu	/mɛˈɲi/
sake	[ˈs̪akɛ]
start	/start/
Amsterdam	/ˈams̪t̪ɛrd̪am/
ich	[ix]
hart	[xaɾt]
igloo	/ˈiɡlu/
brat	[brat]
link	[lʲĩŋk]
dzień dobry	/d͡ʑɛɲ ˈdɔbrɨ/
las	[las]
aha	[ʔaˈxa]
temu	[ˈt̪ɛ̃mu]
jaguar	[jaˈɡuar]
polski	[ˈpɔl̪.s̪ʲkʲi]
sześćdziesiąt	[ʂɛɕˈd͡ʑɛɕɔŋt]
dwanaście	/d̪vaˈn̪aɕt͡ɕɛ/
ta	/t̪a/
ta	/t̪a/
ta	/t̪aː/
delta	/ˈdɛlta/
tort	[tɔrt]
chaos	/ˈxaɔs̪/
lambda	/ˈlambd̪a/
mu	[mu]
dam	[d̪ãm]
premier	[ˈprɛmʲɛr]
atom	/ˈat̪ɔm/
echo	/ˈɛxɔ/
aluminium	[alũˈmʲĩɲũm]
krypton	/ˈkrɨptɔn/
radon	/ˈradɔn/
au	/aw/
na	/na/
co	/t͡s̪ɔ/
samuraj	[saˈmuraj]
po	/pɔ/
tu	[t̪u]
pik	[pʲik]
baba	/ˈbaba/
transparent	/trãsˈparɛnt/
tydzień	/ˈtɨdʑɛɲ/
slogan	[ˈslɔɡan]
problem	[ˈprɔblɛ̃m]
rosyjski	[rɔˈs̪ɨjs̪ʲkʲi]
algebra	[alˈɡɛbra]
Barcelona	/ˌbar.t͡s̪ɛ.ˈlɔ.na/
Berlin	/ˈbɛrlin̪/
Dublin	/ˈd̪ublin̪/
bar	/bar/
Helsinki	/xɛlˈs̪in̪ci/
jest	/jɛst/
zoo	[z̪ɔː]
Kabul	/ˈkabul/
Oslo	/ˈɔs̪lɔ/
Surinam	/suˈrinam/
Tirana	/t̪iˈran̪a/
koper	[ˈkɔpɛr]
psi	[pʲɕi]
psi	[ps̪ʲi]
Uzbek	/ˈuzbɛk/
Bergamo	/ˈbɛrɡamɔ/
Bergamo	/bɛrˈɡamɔ/
Brescia	/ˈbrɛʂːa/
Cagliari	/ˈkaljaˌri/
Cagliari	/kalˈjari/
pole	/ˈpɔlɛ/
kilogram	/kʲiˈlɔɡram/
ohm	/ɔm/
kim	[cĩm]
Coventry	/ˈkɔvɛnˌtri/
Jan	[jan]
Hainaut	/ˈxajnawt/
Namur	/ˈnamur/
Sofia	/ˈs̪ɔfja/
ser	[sɛr]
mit	[mʲit̪]
cent	[t͡s̪ɛn̪t̪]
atlas	/ˈatlas/
beret	/ˈbɛrɛt/
lewa	[ˈlɛva]
plan	[plãn̪]
melon	[ˈmɜ.lɔn]
papa	/ˈpapa/
da	/da/
paw	/paf/
Polska	/ˈpɔlska/
je	[jɛ]
hymn	[xɨmn]
Reykjavik	/ˈrɛjkʲavik/
czar	/t͡ʂar/
Drenthe	/ˈdrɛntɛ/
Flevoland	/ˈflɛ.vɔ.ˌlant/
Flevoland	/ˈflɛi̯.vɔ.ˌlant/
zenit	/ˈz̪ɛɲit̪/
poker	/ˈpɔkɛr/
Groningen	/ˈxrɔɲiŋɡɛn/
Groningen	/ˈxrɔwɲiŋɡɛn/
Overijssel	/ɔvɛˈrɛisɛl/
snooker	/ˈsnukɛr/
sumo	[ˈs̪ũmɔ]
harmonia	/xarˈmɔɲja/
less	/ˈlɛsː/
label	/ˈlɛjbɛl/
mango	[ˈmãŋɡɔ]
system	[ˈsɨstɛm]
Egipt	/ˈɛɡʲipt/
sum	/sum/
glut	/ɡlut/
lupa	/ˈlupa/
herb	/xɛrp/
ton	/t̪ɔn̪/
nie	[ɲɛ]
ja	/ja/
auto	[awtɔ]
tom	[t̪ɔ̃m]
tender	/ˈtɛndɛr/
poniedziałek	[pɔɲɛˈd͡ʑawɛk]
rana	[ˈrana]
Gdańsk	/ɡdaɲsk/
Gdańsk	[ɡd̪ãĩ̯s̪k]
Kraków	[ˈkrakuf]
portal	/ˈpɔrt̪al/
tor	[t̪ɔr]
ren	[rɛ̃n̪]
historia	[xʲis̪ˈt̪ɔrʲja]
dom	/d̪ɔm/
stale	/ˈstalɛ/
niedziela	[ɲɛˈd͡ʑɛla]
sobota	/s̪ɔˈbɔt̪a/
woda	[ˈvɔd̪a]
joker	/ˈd͡ʐɔkɛr/
alarm	/ˈalarm/
alkaloid	/alkaˈlɔ.it̪/
blog	[blɔk]
knot	[kn̪ɔt̪]
amen	/ˈamɛn/
materia	/maˈt̪ɛrja/
katakana	/kataˈkana/
Kongo	/ˈkɔŋɡɔ/
demon	/ˈd̪ɛmɔn̪/
Belgia	/ˈbɛlɡʲa/
film	[fʲilm]
Ruanda	/ruˈanda/
Anglia	[ˈãŋɡlʲja]
do widzenia	/dɔ viˈd͡zɛɲa/
step	/stɛp/
AFC	/ˈa ˈɛf ˈt͡sɛ/
WC	/vu.ˈt͡sɛ/
Celt	/t͡sɛlt/
baseball	/ˈbɛjz̪bɔl/
grab	[ɡrap]
hotel	/ˈxɔt̪ɛl/
sad	/s̪at̪/
panna	/ˈpan̪ːa/
ona	/ˈɔn̪a/
ono	/ˈɔn̪ɔ/
oni	[ˈõɲi]
kura	/ˈkura/
ani	/ˈaɲi/
whisky	/ˈwɨs̪kʲi/
kakao	/kaˈkaɔ/
maj	/maj/
chlap	/xlap/
ulica	[uˈlit͡sa]
toga	[ˈtɔɡa]
wie	[vʲjɛ]
luk	/ˈluk/
malina	/maˈlina/
hiragana	/xiraˈɡana/
koza	/ˈkɔzä/
nimi	[ˈɲĩmʲi]
pasta	/ˈpasta/
tsunami	[t͡s̪s̪ũn̪ãmʲi]
rok	[rɔk]
medal	/ˈmɛdal/
statua	[ˈstatua]
much	/mux/
marchewka	[marˈxɛfka]
albatros	[alˈbatrɔs]
albo	[ˈalbɔ]
chart	[xaɾt]
lista	[lʲis̪t̪a]
has	/xas̪/
por	[pɔr]
para	[ˈpara]
geometria	/ɡɛɔˈmɛt̪rja/
frank	[fraŋk]
fragment	/ˈfraɡmɛnt/
bratanek	/braˈtanɛk/
siostrzeniec	[ɕɔsˈt.ʂɛɲɛt͡s]
droga	[ˈd̪rɔɡa]
bu	/buː/
kondom	[ˈkɔndɔm]
kot	[kɔt̪]
lis	[ˈlis]
ptak	/pt̪ak/
wilk	[vilk]
nóż	[nuʂ]
komputer	/kɔmˈput̪ɛr/
szpital	/ˈʂpital/
telefon	/tɛˈlɛfɔn/
widelec	[vʲiˈdɛlɛt͡s]
place	/ˈplat͡sɛ/
kula	[ˈkula]
tata	/ˈt̪at̪a/
astronomia	[as̪t̪rɔ̃ˈn̪ɔ̃mʲja]
tren	[trɛn]
ode	[ɔˈd̪ɛ]
ma	/ma/
jazz	/d͡ʐɛs/
sauna	/ˈsawna/
sauna	[ˈs̪awn̪a]
kamera	/kaˈmɛra/
bryndza	/ˈbɾɨnd͡za/
dobre	[ˈdɔbrɛ]
fotografia	[fɔtɔˈɡrafʲa]
fotograf	/fɔˈtɔɡraf/
mucha	/muxa/
spaghetti	/s̪paˈɡɛt̪t̪i/
mat	[mat̪]
alkoholik	[al.kɔˈxɔ.lʲik]
trolejbus	[trɔˈlɛjbus]
okno	[ˈɔknɔ]
Arab	/ˈarap/
pod	[pɔt̪]
testament	/tɛˈstamɛnt/
moi	/ˈmɔ.i/
jeden	/ˈjɛd̪ɛn̪/
tam	[t̪ãm]
jak	/jak/
jar	/jar/
oko	[ˈɔkɔ]
autor	[ˈawtɔr]
garb	/ˈɡarb/
lada	[ˈlad̪a]
gad	[ɡat]
wymagać	[vɨˈmaɡat͡ɕ]
wymóc	/ˈvɨmut͡s/
wymagania	[vɨmaˈɡaɲa]
jidysz	[ˈjidɨʂ]
cyborg	/ˈt͡s̪ɨbɔrk/
beryl	/ˈbɛrɨl/
mamba	/ˈmamba/
pizda	[ˈpizda]
parapet	/paˈrapɛt/
przychód	[ˈpʂɨxut]
Andy	[ˈandɨ]
kuna	/ˈkuna/
cena	/ˈt͡sɛna/
smacznego	[smat͡ʂˈnɛɡɔ]
ekran	/ˈɛkran/
anagram	/aˈn̪aɡram/
Biblia	[ˈbʲiblʲja]
Europa	/ɛwˈrɔpa/
znowu	[ˈznɔvu]
prosty	[ˈprɔs̪t̪ɨ]
mors	/mɔrs/
Newcastle	/njuˈkasl̩/
figa	[ˈfʲiɡa]
adept	/ˈadɛpt/
aorta	[aˈɔrta]
argot	[arˈɡɔ]
hadron	/ˈxad̪rɔn̪/
cud	[t͡s̪ut̪]
humus	/ˈxumus/
pas	/pas/
pas	/pas/
pas	/pa/
raj	/raj/
sen	[s̪ɛ̃n̪]
biceps	/ˈbi.tsɛps/
embargo	/ɛmˈbarɡɔ/
lot	/lɔt/
paragon	/paˈraɡɔn/
psalm	/psalm/
stadium	/ˈstadjum/
oczywiście	[ɔt͡ʂɨˈvʲiɕt͡ɕɛ]
słońce	[ˈs̪wɔ̃ɲt͡s̪ɛ]
cis	[t͡ɕis]
siostrzenica	[ɕɔst.ʂɛˈɲit͡sa]
bratanica	[brataˈɲit͡sa]
UEFA	/uˈwɛfa/
zebu	/ˈzɛbu/
remis	/ˈrɛmʲis/
Hades	[ˈxadɛs]
sto	/ˈstɔ/
flak	/flak/
iPod	/ˈajpɔt/
robota	[rɔˈbɔt̪a]
norweski	[n̪ɔrˈvɛs̪ʲkʲi]
gluon	/ˈɡluɔn̪/
fermion	/ˈfɛrmjɔn̪/
lepton	/ˈlɛpt̪ɔn̪/
neutrino	/n̪ɛuˈt̪rin̪ɔ/
ketchup	/ˈkɛt͡ʂup/
firma	/ˈfirmä/
Marcin	/ˈmart͡ɕin̪/
ku	/ku/
oda	/ˈɔda/
melodia	/mɛˈlɔd̪ja/
harakiri	/xaraˈkiri/
pieprzyć	[ˈpʲɛpʂɨt͡ɕ]
dialog	/ˈdjalɔk/
seks	/sɛks/
sushi	/ˈsuɕi/
cheeseburger	[t͡ʃiz̪ˈburɡɛr]
Kijów	[ˈcijuf]
motor	/ˈmɔt̪ɔr/
post	[pɔs̪t̪]
Irak	/ˈirak/
trance	/ˈtrɛ̃s/
trance	/ˈtrɛ̃s/
trance	/ˈtrɛ̃su/
trance	/trɛ̃ˈsɔvi/
trance	/ˈtrɛ̃s/
trance	/ˈtrɛ̃sɛm/
trance	/ˈtrɛ̃ɕɛ/
trance	/ˈtrɛ̃ɕɛ/
hal	/ˈxal/
western	/ˈwɛstɛrn/
Arkansas	[ˈarkãz̪as̪]
Connecticut	/kɔˈn̪ɛkt̪ikat̪/
Delaware	/ˈd̪ɛlɛwɛr/
ananas	[aˈna.nas]
halo	/ˈxalɔ/
tal	/tal/
uniform	[uˈɲifɔrm]
Manchester	/ˈmant͡ʂɛsˌtɛr/
Manchester	/ˈmɛnt͡ʂɛsˌtɛr/
Manchester	/manˈt͡ʂɛstɛr/
Manchester	/mɛnˈt͡ʂɛstɛr/
banda	[ˈbãn̪d̪a]
ze	/zɛ/
brody	/ˈbrɔdɨ/
polka	/ˈpɔlka/
Barbara	/barˈbara/
pita	[ˈpʲita]
podcast	/ˈpɔtkast/
etymologia	[ɛtɨmɔˈlɔɡʲja]
hej	[xɛj]
Kamerun	/kaˈmɛrun/
Kanada	/kaˈnada/
energia	[ɛˈnɛrɡʲa]
ponieważ	[pɔˈɲɛvaʂ]
kilka	[ˈkilka]
korekta	[kɔˈɾɛkta]
graham	/ˈɡraxam/
spod	[s̪pɔt̪]
supermarket	[supɛrˈmarkɛt]
adres	/ˈadrɛs/
kto	/ktɔ/
parking	[ˈparcĩŋk]
cholera	/xɔˈlɛra/
Microsoft	/ˈmajkrɔˌsɔft/
angina	/anˈɟina/
potas	[ˈpɔtas]
oso	/ˈɔsɔ/
profil	[ˈprɔfʲil]
brzoza	/ˈbʐɔ.za/
geografia	/ɡɛ.ɔˈɡräfʲä/
HP	/ha ˈpɛ/
centrum	[ˈt͡sɛntrum]
strata	/ˈstrata/
Sahara	/saˈxara/
nobel	/ˈnɔbɛl/
teoria	/t̪ɛˈɔrja/
atmosfera	/at̪mɔs̪ˈfɛra/
turban	[ˈt̪urbãn̪]
patent	/ˈpatɛnt/
meta	/mɛta/
foton	[ˈfɔtɔn]
oregano	/ɔrɛˈɡan̪ɔ/
karat	/ˈkarat/
wtorek	/ˈftɔrɛk/
środa	[ˈɕrɔd̪a]
czwartek	[ˈt͡ʂfartɛk]
piątek	[ˈpʲjɔ̃n̪t̪ɛk]
Hermes	/ˈxɛrmɛs/
sens	[sens]
gór	/ˈɡur/
Knossos	/ˈknɔs.sos/
znak	/znak/
Serbia	/ˈsɛrbja/
chips	[t͡ʂips]
Afganistan	/avɡaˈɲistan/
Maria	/ˈmarja/
mulcz	/mult͡ʂ/
homoseksualny	[xɔmɔsɛksuˈalnɨ]
homoseksualista	/xɔmɔsɛksuaˈlista/
perle	/ˈpɛrlɛ/
a	/a/
Ale	/ˈalɛ/
Anna	/ˈan̪ːa/
Apple	/ˈɛpl/
Bug	[buk]
Hydra	/ˈxɨdra/
Kot	[kɔt̪]
Kuba	/ˈkuba/
Lier	/lir/
Liège	/ˈljeʂ/
Macao	/maˈkaɔ/
Macintosh	/maˈkintɔʂ/
Maj	[ˈmaj]
Monako	/mɔˈnakɔ/
Nil	/ɲil/
Panna	/ˈpan̪ːa/
Pers	/pɛrs/
Polka	/ˈpɔlka/
Ren	[rɛn]
Słońce	[ˈs̪wɔ̃ĩ̯n̪t͡s̪ɛ]
Uran	[ˈuran]
oman	/ˈɔman/
liberia	/liˈbɛrja/
polska	[ˈpɔls̪ka]
einstein	[ˈajnʂtajn]
daniel	/ˈd̪aɲɛl/
sam	[s̪ãm]
dane	/ˈdanɛ/
planeta	[plaˈnɛta]
pierogi	[pʲɛˈrɔɟi]
Islandia	/iˈslandja/
jogurt	/ˈjɔɡurt/
łaciński	/waˈt͡ɕĩj̃sʲci/
Łódź	/wuːt͡ɕ/
sura	/ˈs̪ura/
Swansea	/ˈswɔnzi/
farby	/ˈfarbɨ/
być	[bɨt͡ɕ]
Andora	[anˈdɔra]
angielski	[ãŋˈɟɛls̪ci]
lump	[lũmp]
pismo	[ˈpʲis̪mɔ]
słoń	/s̪wɔɲ/
koń	/kɔɲ/
jantar	[ˈjantaɾ]
grill	/ɡril/
maku	/ˈmaku/
ara	/ˈara/
lato	[ˈlatɔ]
techno	/ˈtɛxnɔ/
oczy	[ɔt͡ʂɨ]
mną	[mn̪ɔ̃w̃]
jej	[jej]
Japonia	/jaˈpɔɲja/
uszom	/ˈuʂɔm/
ucho	[ˈuxɔ]
polscy	/ˈpɔlst͡sɨ/
Moskwa	[ˈmɔskfa]
Wiedeń	/ˈvʲɛd̪ɛɲ/
Francja	/ˈfrant͡sja/
Włochy	/ˈvwɔxɨ/
Białoruś	/bʲjaˈwɔruɕ/
polskim	[ˈpɔlskʲim]
runo	/ˈrunɔ/
pszczoła	[ˈpʂt͡ʂɔwa]
Ukraina	/ukraˈin̪a/
Słowacja	/swɔˈvat͡sja/
kaon	/ˈkaɔn̪/
sok	/sɔk/
itd.	/i tak dalɛj/
jutro	[ˈjut̪rɔ]
aktor	[ˈaktɔr]
aktorka	/akˈtɔrka/
śnieg	/ɕɲɛk/
zim	[ʑim]
prawda	[ˈpravda]
Niemcy	/ˈɲemt͡sɨ/
Jemen	/ˈjɛmɛn/
Litwa	[ˈlʲitfa]
dobry	/ˈd̪ɔbrɨ/
dobrą	[ˈd̪ɔbrɔ̃w̃]
międzynarodowy	/mʲɛ̃d͡zɨnarɔˈdɔvɨ/
Kolumbia	/kɔˈlumbja/
pierwszy	[ˈpʲjɛrfʂɨ]
sześć	/ˈʂɛɕt͡ɕ/
Węgry	/ˈvɛŋɡrɨ/
iBook	/ˈajbuk/
jen	[jɛ̃n̪]
iMac	/ˈajmak/
flet	[ˈflɛt]
swat	/sfat/
Teheran	/t̪ɛˈxɛran̪/
tlen	/tlɛn/
logarytm	[lɔˈɡarɨt̪m̥]
listopad	/lisˈtɔpat/
dnia	/dɲa/
cela	/ˈt͡s̪ɛla/
pisze	/ˈpiʂɛ/
śpiewać	[ˈɕpʲɛvat͡ɕ]
kapo	[ˈkapɔ]
banki	[ˈbãŋʲkʲi]
Bogota	/bɔˈɡɔta/
Bogota	[bɔˈɡɔt̪ä]
Bogota	/ˌbɔɡɔˈta/
Bogota	[ˌbɔɡɔˈt̪ä]
talar	[ˈtalar]
haf	[xaf]
kort	/kɔrt̪/
balkon	/ˈbalkɔn̪/
sól	/s̪ul/
taka	[ˈt̪aka]
inne	[ˈĩn̪ːɛ]
Kirgistan	/kʲirˈɡʲistan/
kultura	[kulˈt̪ura]
francuski	/fran̪ˈt͡s̪us̪kʲi/
politechnika	[pɔlʲiˈtɛxɲika]
bez	[bɛs̪]
orne	/ˈɔrnɛ/
mężczyzna	[mɛ̃ˈʂt͡ʂɨz̪n̪a]
niechlujny	[ɲɛˈxlujnɨ]
Etiopia	/ɛˈtjɔpja/
Madagaskar	/madaˈɡaskar/
casting	[ˈkas̪t̪ʲĩŋk]
delfin	/ˈdɛlfin/
Paryż	/ˈparɨʂ/
Singapur	/siŋˈɡapur/
Maroko	/maˈrɔkɔ/
drzewo	[ˈdʐɛvɔ]
drzewo	[ˈd͡ʐʐɛvɔ]
ulice	/uˈlit͡sɛ/
słodki	/ˈs̪wɔt̪kʲi/
gen	/ɡɛn̪/
Katar	[ˈkatar]
boks	[bɔks̪]
jeść	[jeɕt͡ɕ]
im	[ĩm]
lat	[lat̪]
kometa	/kɔˈmɛta/
itr	[it̪r̥]
rydwan	[ˈrɨdvan]
masa	/ˈmas̪a/
gaz	/ɡas̪/
palma	[ˈpalma]
ducha	/ˈduxa/
Komi	[ˈkɔ̃mʲi]
boku	/ˈbɔku/
Tromsø	/ˈtrɔmsɛ/
Tromsø	/ˈtrumsɛ/
dobra	/ˈdɔbra/
doktor	[ˈd̪ɔkt̪ɔr]
dama	/ˈdama/
bak	[bak]
hel	[xɛl]
srebrna	/ˈsrɛbrna/
hala	/ˈxala/
różowy	/ruˈʐɔvɨ/
czerwony	/t͡ʂɛrˈvɔn̪ɨ/
zielony	/ʑɛˈlɔn̪ɨ/
żółty	/ˈʐuwt̪ɨ/
niebieski	[ɲɛbʲjɛsʲkʲi]
stadia	/ˈstadja/
czarny	[ˈt͡ʂarn̪ɨ]
skarpeta	[skarˈpɛta]
płaszcz	[pwaʂt͡ʂ]
czekać	/ˈt͡ʂɛkat͡ɕ/
lata	[ˈlat̪a]
prepaid	[ˈprɛ.pajt]
prepaid	[pri.pɛjt]
nosy	/ˈnɔsɨ/
cep	/t͡s̪ɛp/
kasa	/ˈkasa/
kusza	/ˈkuʂa/
chuj	/xuj/
noga	[ˈn̪ɔɡa]
mary	/ˈmarɨ/
boja	[ˈbɔja]
druk	[d̪ruk]
dup	[ˈdup]
Horus	/ˈxɔrus/
runa	/ˈruna/
azot	ˈazɔt
harfa	/ˈxarfa/
osa	/ˈɔsa/
grom	/ɡrɔm/
dobro	/ʼd̪ɔbɾɔ/
Malezja	/maˈlɛzja/
sumach	/ˈsumax/
Stany Zjednoczone	/ˈstanɨ zjɛdnɔˈt͡ʂɔnɛ/
ful	/ful/
Karelia	[kaˈrɛlʲja]
rzeczpospolita	/ʐɛt͡ʂpɔsˈpɔʎita/
kos	[kɔs]
kosa	/ˈkɔsa/
cal	/t͡sal/
nic	/ɲit͡s/
coś	[t͡s̪ɔɕ]
ktoś	[ktɔɕ]
zaimki	/zaˈimci/
zaimek	/ˈzaimɛk/
jego	[ˈjɛɡɔ]
wy	/vɨ/
państwo	/ˈpaɲstfɔ/
pani	[ˈpãɲi]
manicure	/maɲiˈkʲir/
grody	[ˈɡrɔdɨ]
Aalborg	/ˈɔlbɔr/
Aalborg	/ˈɔlbɔrk/
Aarhus	/ˈɔrxus/
koks	/kɔks/
pepsi	/ˈpɛps̪i/
Kazachstan	/kaˈz̪axs̪t̪an̪/
jako	/ˈjakɔ/
jakoby	/jaˈkɔbɨ/
obraz	/ˈɔbras/
tato	/ˈt̪at̪ɔ/
Krystyna	/krɨˈs̪t̪ɨn̪a/
nara	[ˈn̪ara]
flota	/ˈflɔta/
Mauretania	/mawrɛˈtaɲja/
cel	[t͡sɛl]
gips	[ɟips̪]
mleko	/ˈmlɛkɔ/
barman	[ˈbarmãn̪]
sporty	/ˈspɔrtɨ/
pana	[ˈpãn̪a]
headshot	/ˈhɛtʂɔt/
sny	[s̪n̪ɨ]
len	/lɛn̪/
tutaj	[ˈt̪ut̪aj]
tej	[t̪ɛj]
fal	/fal/
fos	/fɔs/
huta	/xut̪a/
tego	[ˈt̪ɛɡɔ]
kora	/ˈkɔra/
kusi	[ˈkuɕi]
kosz	/kɔʂ/
kapa	[ˈkapa]
tarka	[ˈt̪arka]
mech	[mɛx]
inni	[ˈĩɲːi]
jaki	[ˈjaci]
wolfram	[ˈvɔlfram]
karp	/karp/
kont	/kɔn̪t̪/
kino	/ˈkʲinɔ/
mur	/mur/
kupa	/ˈkupa/
oba	[ˈɔba]
dobry wieczór	/ˌd̪ɔbrɨ ˈvjɛt͡ʂur/
wieczór	/ˈvʲjɛt͡ʂur/
dobranoc	[d̪ɔˈbrãn̪ɔt͡s̪]
proszę	/ˈprɔʂɛ/
przepraszam	/pʂɛˈpraʂam/
na zdrowie	/na ˈzdrɔvjɛ/
dlaczego	/dlaˈt͡ʂɛɡɔ/
gra	[ɡra]
liść	[lʲiɕt͡ɕ]
raz	[ˈras]
nas	[n̪as̪]
fala	/ˈfala/
fosfor	/ˈfɔsfɔr/
ruten	[ˈrutɛn]
taon	/ˈtaon/
taon	[ˈt̪aɔn̪]
lutet	/ˈlutɛt/
czapka	[ˈt͡ʂapka]
dany	[ˈdanɨ]
tur	/tur/
lotnisko	[lɔtˈɲiskɔ]
bór	/bur/
boso	/ˈbɔsɔ/
cera	[ˈt͡sɛra]
brud	/brut/
buk	[buk]
chory	[ˈxɔrɨ]
doba	/ˈdɔba/
drogi	[ˈd̪rɔɟi]
ksenon	[ˈksɛnɔn]
kruk	/kruk/
lud	/lut̪/
moc	[mɔt͡s̪]
stary	[ˈs̪t̪arɨ]
serce	[ˈs̪ɛrt͡s̪ɛ]
ocet	[ˈɔt͡sɛt]
obrus	/ˈɔbrus̪/
szelki	[ˈʂɛlki]
taki	[ˈt̪aci]
ul	/ul/
usta	[ˈusta]
wiek	[vʲjɛk]
winda	[ˈvinda]
ruda	/ˈruda/
sekund	[ˈs̪ɛkũn̪t̪]
sekunda	/s̪ɛˈkun̪d̪a/
brak	/brak/
kod	/kɔt̪/
Göteborg	/ˈɡɛtɛbɔrk/
kantor	/ˈkan̪t̪ɔr/
jagoda	/jaˈɡɔd̪a/
ciemny	/ˈt͡ɕɛmn̪ɨ/
ciepły	[ˈt͡ɕɛpwɨ]
ciało	/ˈt͡ɕawɔ/
ciasny	/ˈt͡ɕas̪n̪ɨ/
ciasto	[ˈt͡ɕas̪t̪ɔ]
cichy	[ˈt͡ɕixɨ]
nami	[ˈn̪ãmʲi]
nasi	[ˈnaɕi]
broda	/ˈbrɔda/
brodu	[ˈbrɔdu]
rano	/ˈranɔ/
oto	/ˈɔtɔ/
tani	[ˈtaɲi]
cer	/t͡sɛr/
pacha	/ˈpaxa/
glin	[ɡlin]
spadochron	[spaˈdɔxrɔn]
dali	[ˈd̪alʲi]
kokos	/ˈkɔkɔs̪/
Helena	/xɛˈlɛn̪a/
wami	[ˈvãmʲi]
maju	/ˈmaju/
orz	[ɔʂ]
pić	[pʲit͡ɕ]
byk	/bɨk/
chyba	/ˈxɨba/
wyspa	/ˈvɨs̪pa/
mięsień	[ˈmʲjẽĩ̯ɕẽɲ]
pstrąg	[ps̪t̪rɔ̃ŋk]
córka	/ˈt͡surka/
smak	[smak]
mieli	[ˈmʲjɛlʲi]
kraj	[kraj]
mam	[mãm]
kość	/kɔɕt͡ɕ/
ferm	[fɛrm]
dzień	[d͡ʑɛ̝̃ɲ]
granica	[ɡraˈɲit͡sa]
ogórek	/ɔˈɡurɛk/
debil	/ˈdɛbil/
smok	/smɔk/
gamepad	/ɡɛjmˈpat/
podcasting	/pɔtˈkastiŋk/
Wimbledon	/ˈwimblɛˌdɔn/
wafel	[ˈvafɛl]
Petersburg	[pɛˈt̪ɛrs̪burk]
waga	[ˈvaɡa]
wola	/ˈvɔla/
bosi	/ˈbɔɕi/
faul	/fawl/
beton	/ˈbɛt̪ɔn̪/
epilog	[ɛˈpilɔk]
Filip	[ˈfʲilʲip]
Kenia	/ˈkɛɲja/
złoto	/ˈzwɔtɔ/
żona	/ˈʐɔna/
uda	[ˈud̪a]
hostia	[ˈxɔstʲia]
kandela	/kan̪ˈd̪ɛla/
pisać	/ˈpʲisat͡ɕ/
panem	[ˈpãn̪ɛ̃m]
brama	[ˈbrama]
parna	/ˈparna/
lipiec	/ˈlipjɛts/
Malmö	/ˈmalmɛ/
Düsseldorf	/ˈdisɨldɔrf/
Düsseldorf	/ˈdɨsɨldɔrf/
leasing	[ˈlʲiz̪ʲĩŋk]
catering	[kaˈt̪ɛrʲĩŋk]
Pearl Harbor	/ˌpɛr(l) ˈxarbɔr/
luty	/lutɨ/
styczeń	[ˈstɨt͡ʂɛɲ]
marzec	/maʐɛts/
kwiecień	[ˈkfjɛt͡ɕɛɲ]
sierpień	/ˈɕɛrpjɛɲ/
wrzesień	/vʐɛɕɛɲ/
październik	/paʑˈdʑɛrɲik/
Portugalia	/pɔrtuˈɡalja/
Hiszpania	/çiˈʂpaɲa/
Irlandia	/irˈlandja/
Norwegia	/nɔrˈvɛɡʲa/
Szwecja	/ˈʂfɛt͡s̪ja/
Luksemburg	/ˈluksɛmburk/
Holandia	/xɔˈlandja/
Szwajcaria	/ʂfajˈt͡s̪arja/
Grecja	/ˈɡrɛt͡sja/
obszar	/ˈopʃar/
Malaga	/ˈmalaɡa/
Malaga	[ˈmäläɡä]
Malaga	/maˈlaɡa/
Malaga	[mäˈläɡä]
Bułgaria	/buwˈɡarja/
Rumunia	/ruˈmuɲja/
Będzin	/ˈbɛɲd͡ʑin/
posiadać	[pɔˈɕadat͡ɕ]
złamać	[ˈzwamat͡ɕ]
tuńczyk	/ˈtuɲt͡ʂɨk/
często	/ˈt͡ʂɛ̃stɔ/
Apia	/ˈapja/
Sparta	/ˈsparta/
Dagestan	[d̪aˈɡɛs̪t̪ãn̪]
ząb	[z̪ɔ̃mp]
włosy	[ˈvwɔsɨ]
ryba	[ˈrɨba]
drum and bass	/dram ɛn ˈbɛjs/
śniadanie	[ɕɲaˈd̪ãɲɛ]
darach	[ˈdarax]
muł	[muw]
aleje	/aˈlɛjɛ/
zawsze	[ˈz̪afʂɛ]
debata	/dɛˈbata/
chrząszcz	/xʂɔ̃ʂt͡ʂ/
skunks	/ˈskuŋks/
przykład	/ˈpʂɨkwat/
biologia	[bʲjɔˈlɔɟja]
mamo	[ˈmãmɔ]
moja	[ˈmɔja]
moje	[ˈmɔjɛ]
nade	[ˈnadɛ]
orle	/ˈɔrlɛ/
orna	/ˈɔrna/
osad	/ˈɔsat/
lody	/ˈlɔdɨ/
naleśnik	/naˈleɕɲik/
chmura	/ˈxmura/
mgła	/mɡwa/
łacina	/waˈt͡ɕina/
łabędź	/ˈwabɛɲt͡ɕ/
lód	/lut̪/
lśniący	[ˈl̥ʲɕɲɔ̃n̪t͡s̪ɨ]
gdzie	/ɡd͡ʑɛ/
ogonek	[ɔˈɡɔnɛk]
się	/ɕɛ̃/
się	 [ɕɛ̃w̃]
przepraszać	/pʂɛˈpraʂat͡ɕ/
bardzo	[ˈbard͡zɔ]
szkodzić	/ˈʂkɔd͡ʑit͡ɕ/
prosić	/ˈprɔɕit͡ɕ/
dziękować	[d͡ʑɛ̃ŋˈkɔvat͡ɕ]
porządek	[pɔˈʐɔ̃n̪d̪ɛk]
widzenie	/viˈd͡zɛɲɛ/
widzenia	/viˈd͡zɛɲa/
turysta	/tuˈrɨsta/
dobrze	/ˈdɔbʐɛ/
dobrze	[ˈdɔpʂ(ː)]
wszystko	/ˈfʂɨstkɔ/
życzyć	/ˈʐɨt͡ʂɨt͡ɕ/
pobyt	/ˈpɔbɨt/
potrzebować	/pɔtʂɛˈbɔvat͡ɕ/
słuchać	/ˈswuxat͡ɕ/
nazywać	/naˈzɨvat͡ɕ/
móc	[mut͡s]
znajdować	/znajˈdɔvat͡ɕ/
chwila	[ˈxfʲila]
czy	/t͡ʂɨ/
nazwisko	/nazˈviskɔ/
imię	/ˈimʲjɛ/
uważać	/uˈvaʐat͡ɕ/
mówić	/ˈmuvit͡ɕ/
życzenie	/ʐɨˈt͡ʂɛɲɛ/
rodzina	/rɔˈd͡ʑina/
mąż	[mɔ̃w̃ʂ]
poznać	/ˈpɔznat͡ɕ/
chcieć	/xt͡ɕɛt͡ɕ/
przyjaciel	/pʂɨˈjat͡ɕɛl/
cudzoziemiec	/t͡sud͡zɔˈʑɛmʲɛt͡s/
uczyć	/ˈut͡ʂɨt͡ɕ/
słowo	/ˈswɔvɔ/
ćma	/t͡ɕma/
samochód	/s̪aˈmɔxut̪/
świat	[ˈɕfʲjat]
ołówek	/ɔˈwuvɛk/
niestety	/ɲɛˈstɛtɨ/
pomyłka	/pɔˈmɨwka/
wewnętrzny	[vɛˈvn̪ɛ̃nt͡ʂn̪ɨ]
łączyć	[ˈwɔ̃nt͡ʂɨt͡ɕ]
przy	/pʂɨ/
niespodzianka	/ɲɛspɔˈd͡ʑanka/
dodzwonić się	/dɔˈd͡z̪vɔɲit͡ɕ ɕɛ/
miecz	[mʲjɛt͡ʂ]
ochota	/ɔˈxɔta/
wspólny	/ˈfs̪puln̪ɨ/
obiad	/ˈɔbjat̪/
przyjemność	/pʂɨˈjɛmnɔɕt͡ɕ/
plac	/plat͡s/
cztery	/ˈt͡ʂtɛrɨ/
pięć	/ˈpʲjɛɲt͡ɕ/
siedem	/ˈɕɛd̪ɛm/
osiem	/ˈɔɕɛm/
dziewięć	/ˈd͡ʑɛvʲjɛɲt͡ɕ/
dziesięć	/ˈd͡ʑɛɕɛɲt͡ɕ/
nadzieja	/naˈd͡ʑeja/
że	/ʐɛ/
wygodnie	/vɨˈɡɔdɲɛ/
wszelki	/fʂɛlkʲi/
wypadek	/vɨˈpadɛk/
dzwonić	/ˈd͡zvɔɲit͡ɕ/
tylko	/ˈtɨlkɔ/
notować	/nɔˈtɔvat͡ɕ/
teraz	/ˈtɛras/
okazja	/ɔˈkazja/
zaraz	/ˈzaras/
świetnie	/ˈɕfʲɛtɲɛ/
rozumieć	/rɔˈzumjɛt͡ɕ/
przez	/pʂɛs/
łatwy	/ˈwatfɨ/
jechać	/ˈjɛxat͡ɕ/
skręcić	[ˈs̪krɛ̃ɲt͡ɕit͡ɕ]
pierś	/pʲjɛrɕ/
prawo	/ˈpravɔ/
parno	/ˈparnɔ/
fraktal	/ˈfraktal/
herbu	[ˈxɛrbu]
sobie	[ˈs̪ɔbʲjɛ]
pociąg	/ˈpɔt͡ɕɔŋk/
dzisiaj	[ˈd͡ʑiɕɐj]
robić	/ˈrɔbit͡ɕ/
piękny	[ˈpʲjɛ̃ŋkn̪ɨ]
zwiedzać	[ˈz̪vʲjɛd͡z̪at͡ɕ]
wybierać	/vɨˈbjɛrat͡ɕ/
zamek	/ˈzamɛk/
morze	/ˈmɔʐɛ/
żubr	[ʐupr̥]
skrzyżowanie	/skʂɨʐɔˈvaɲɛ/
aż	/aʂ/
słyszeć	/ˈswɨʂɛt͡ɕ/
natychmiast	/naˈtɨxmjast/
gasić	/ˈɡaɕit͡ɕ/
zdjęcie	/ˈzdjɛɲt͡ɕɛ/
musieć	[ˈmuɕet͡ɕ]
zostawiać	/zɔˈstavjat͡ɕ/
aparat	/aˈparat/
fotograficzny	/fɔt̪ɔɡraˈfit͡ʂn̪ɨ/
butów	[ˈbutuf]
deszcz	[dɛʂt͡ʂ]
wyglądać	[vɨˈɡlɔ̃n̪d̪at͡ɕ]
pedał	/ˈpɛdaw/
chleb	/xlɛp/
alkan	/ˈalkan/
rower	[ˈrɔvɛr]
Aleksandra	/alɛˈks̪an̪d̪ra/
Aleksander	[alɛˈksandɛr]
nim	[ɲĩm]
no	[n̪ɔ]
siano	[ˈɕanɔ]
szukać	/ˈʂukat͡ɕ/
acetylen	[at͡sɛˈtɨlɛn]
Jordania	/jɔrˈdaɲja/
Kalifornia	/kaliˈfɔrɲja/
dym	/dɨm/
rada	/rada/
piernik	/ˈpʲɛr.ɲik/
wiatr	[vʲjat̪r̥]
niska	[ˈɲiska]
gry	/ɡrɨ/
antropologia	[antrɔpɔˈlɔɡʲa]
biały	[ˈbʲjawɨ]
ogon	[ˈɔɡɔn]
lasu	/ˈlasu/
temperatura	[tɛmpɛraˈtura]
jabłko	[ˈjapw̥.kɔ]
jabłko	[ˈjap.kɔ]
łosoś	/ˈwɔsɔɕ/
truskawka	/trusˈkafka/
padać	/ˈpadat͡ɕ/
joypad	/d͡ʐɔjˈpɛt/
wymowa	[vɨˈmɔva]
alkohol	/alˈkɔxɔl/
Jezus	/ˈjɛzus/
iPhone	/ˈajfɔn/
anatomia	[anaˈtɔmʲa]
pan	/pan̪/
kowal	/ˈkɔval/
Belgrad	/ˈbɛlɡrat̪/
Ibiza	[iˈbʲiz̪a]
gaje	/ˈɡajɛ/
kabel	[ˈkabɛl]
kocham cię	/ˈkɔxam t͡ɕɛ/
tapeta	[taˈpɛta]
apatia	/aˈpat̪ja/
legenda	/lɛˈɡɛnda/
terapia	/t̪ɛˈrapja/
banan	[ˈbãn̪ãn̪]
Dniepr	/dɲepr/
pyton	/ˈpɨtɔn/
krypta	/ˈkrɨpt̪a/
kilometr	[ciˈlɔ̃mɛt̪r̥]
nowa	[ˈnɔva]
amper	/ˈampɛr/
korund	/ˈkɔrunt/
jezioro	[jɛˈʑɔrɔ]
zoolog	[z̪ɔˈɔlɔk]
ropucha	/rɔˈpuxa/
drozd	[drɔst]
sernik	/ˈs̪ɛrɲik/
horoskop	/xɔˈrɔs̪kɔp/
konto	/ˈkɔn̪t̪ɔ/
palec	[ˈpalɛt͡s]
mnich	[mʲɲix]
kojot	/ˈkɔjɔt/
stopa	[ˈstɔpa]
Izrael	/iˈzrael/
botanika	/bɔˈt̪aɲika/
kutas	[ˈkut̪as̪]
duch	[dux]
lotniskowiec	[lɔt̪ʲɲiˈs̪kɔvʲjɛt͡s̪]
grupa	[ˈɡrupa]
kompas	/ˈkɔmpas/
bilet	[ˈbʲilɛt̪]
wu	/vu/
miska	[ˈmʲis̪ka]
traktor	[ˈtraktɔr]
strach	[strax]
puzon	/ˈpuzɔn/
wąż	[vɔ̃w̃ʂ]
wąż	[vɔ̃ʂ]
jeż	[jɛʂ]
pszczółka	/pʂˈt͡ʂuwka/
fregata	/frɛˈɡata/
opat	[ˈɔpat]
biskup	/ˈbiskup/
wasi	[ˈvaɕi]
lucerna	/luˈt͡s̪ɛrn̪a/
karta	/ˈkarta/
rekord	/ˈrɛkɔrt̪/
kotlet	[ˈkɔt̪lɛt̪]
lider	[ˈlidɛr]
makaron	/maˈkarɔn̪/
antonim	[anˈtɔɲim]
marksizm	/ˈmarʲcɕism̥/
mebel	[ˈmɛbɛl]
polonez	/pɔˈlɔn̪ɛs̪/
mitologia	[mʲitɔˈlɔɡʲa]
metr	[mɛt̪r̥]
ciastko	[ˈt͡ɕas̪t̪kɔ]
filtr	[fʲilt̪r̥]
flot	/flɔt/
ogień	/ˈɔɡʲɛɲ/
muli	[ˈmulʲi]
piki	[ˈpʲikʲi]
kaktus	/ˈkakt̪us̪/
kategoria	[katɛˈɡɔrʲa]
tona	/ˈt̪ɔn̪a/
margaryna	/marɡaˈrɨna/
komp	[kɔ̃mp]
szary	/ˈʂarɨ/
blada	/ˈblada/
mieć	[mʲjet͡ɕ]
cukier	[ˈt͡s̪ucɛr]
gąbka	[ˈɡɔmpka]
sos	/s̪ɔs̪/
eksport	/ˈɛkspɔrt/
kolos	/ˈkɔlɔs/
portugalski	[pɔrt̪uˈɡals̪ʲkʲi]
Turek	/ˈt̪urɛk/
kania	/ˈkaɲa/
unia	/ˈuɲja/
syty	/ˈsɨtɨ/
filologia	/filɔˈlɔɡja/
muzeum	[muˈzɛum]
entalpia	[ɛnˈtalpʲa]
komin	/ˈkɔmʲin/
mili	/ˈmi.li/
dusza	/ˈduʂa/
miód	[mʲut̪]
hokej	[ˈxɔkɛj]
Internet	/inˈtɛrnɛt/
chór	[xur]
czytać	[ˈt͡ʂɨtat͡ɕ]
sile	/ˈɕilɛ/
broń	[brɔ̃ɲ]
żółć	[ʐuwt͡ɕ]
lustro	/ˈlustrɔ/
grosz	[ɡrɔʂ]
rzecz	[ʐɛt͡ʂ]
łóżko	/ˈwuʂkɔ/
gałąź	[ˈɡawɔ̃ĩ̯ɕ]
pchła	[pxwa]
motocykl	[mɔˈtɔt͡sɨkl]
plaża	[ˈplaʐa]
Kreta	/ˈkrɛta/
Katalonia	/kat̪aˈlɔɲja/
ministrant	/mʲĩˈɲistrãnt/
flaga	/ˈflaɡa/
ryż	[rɨʂ]
napój	[ˈnapuj]
lemoniada	/lɛmɔˈɲada/
szampan	/ˈʂampan/
koniak	[ˈkɔɲak]
likier	[ˈlikʲɛr]
młyn	[mwɨn]
borsuk	/ˈbɔrsuk/
niedźwiedź	[ˈɲed͡ʑvʲjet͡ɕ]
bóbr	[ˈbupr]
cielę	[t͡ɕɛlɛ]
kogut	[ˈkɔɡut]
babcia	/ˈbapt͡ɕa/
dziadek	[ˈd͡ʑad̪ɛk]
kompost	[ˈkɔ̃mpɔs̪t̪]
epos	/ˈɛpɔs/
projekt	/ˈprɔjɛkt̪/
kakadu	/kaˈkadu/
musi	[ˈmuɕi]
bazalt	/ˈbazalt/
Piotr	[pʲɔt̪r̥]
kajak	[ˈkajak]
ciota	/ˈt͡ɕɔta/
aua	/aˈwaː/
pusta	/ˈpusta/
amnestia	[amˈnɛstja]
bełkot	/ˈbɛwkɔt̪/
Ania	/ˈaɲa/
siatkówka	[ɕat̪ˈkufka]
fonem	[ˈfɔnɛm]
pól	/pul/
jaz	/jas/
pierdut	[pʲɛrˈdut]
Ewa	/ˈɛva/
aneks	[ˈãnɛks]
mózg	/mus̪k/
agentura	/ˈaɡɛ̃ntura/
agregat	/aɡˈre.ɡat/
metoda	/mɛˈtɔda/
akronim	[aˈkrɔɲim]
alpaka	[alˈpaka]
erb	/ɛrp/
Paulina	[pawˈli.na]
Paulina	[pa.uˈli.na]
Amazonka	/amaˈz̪ɔn̪ka/
korona	/kɔˈrɔna/
lantan	/ˈlantan/
tantal	/ˈtantal/
bizmut	[ˈbizmut]
astat	/ˈastat/
arsen	[ˈarsɛn]
fenol	/ˈfɛnɔl/
kochanie	[kɔˈxãɲɛ]
Lesoto	/lɛˈsɔtɔ/
Mozambik	/mɔˈzambik/
matki	/ˈmat̪ci/
akt	/akt/
azerski	[aˈz̪ɛrs̪ʲkʲi]
cegła	[ˈt͡sɛ.ɡwa]
dech	/d̪ɛx/
fonon	/ˈfɔnɔn/
jestem	/ˈjɛs̪t̪ɛm/
ziemniak	/ˈʑɛmɲak/
papryka	/paˈprɨka/
sałata	/saˈwata/
sałata	[s̪aˈwat̪a]
burak	/ˈburak/
rzeżucha	[ʐɛˈʐuxa]
kalafior	[kaˈla.fʲjɔr]
brokuł	[ˈbrɔ.kuw]
czosnek	[ˈt͡ʂɔs.nɛk]
cukinia	/t͡s̪uˈciɲja/
dynia	/ˈdɨɲa/
szpinak	[ˈʂpʲinak]
ojciec	/ˈɔjt͡ɕɛt͡s̪/
ortografia	/ɔrt̪ɔˈɡrafja/
napletek	[naˈplɛtɛk]
srebrny	[ˈsrɛbrnɨ]
fioletowy	[fʲɔlɛˈtɔvɨ]
błękitny	[bwɛ̃ŋʲˈkʲit̪n̪ɨ]
smutek	[ˈsmutɛk]
Eleonora	/ɛlɛɔˈn̪ɔra/
ścieżka	/ˈɕt͡ɕɛʂka/
Bangladesz	/baŋɡlaˈdɛʂ/
Indie	/ˈindjɛ/
Kuwejt	/ˈkuvɛjt/
Jamajka	/jaˈmajka/
przecinek	/pʂɛˈt͡ɕin̪ɛk/
Czad	/t͡ʂat/
indyk	[ˈindɨk]
Wietnam	/ˈvjɛt̪n̪am/
waliza	[vaˈliza]
kocur	[ˈkɔt͡sur]
wymiotować	/vɨmjɔˈtɔvat͡ɕ/
kocica	[kɔˈt͡ɕit͡s̪a]
nonsens	[ˈn̪ɔ̃s̪ɛ̃s̪]
słonica	[swɔˈɲit͡sa]
marsz	[marʂ]
maszerować	[maʂɛˈrɔvat͡ɕ]
protokół	[prɔˈtɔkuw]
notatka	[nɔˈtatka]
malutki	/maˈlut̪kʲi/
głowa	[ˈɡwɔva]
kierowniczka	[kʲɛrɔˈvɲit͡ʂka]
kierować	[kʲɛˈrɔvat͡ɕ]
imiona	[iˈmjɔna]
godność	[ˈɡɔdnɔɕt͡ɕ]
nazwa	[ˈnazva]
reputacja	[rɛpuˈtat͡sja]
wskazać	/ˈfskazat͡ɕ/
liczydło	[liˈt͡ʂɨdwɔ]
sława	[ˈswava]
jesień	/ˈjɛɕɛɲ/
źródło	[ˈʑrud̪wɔ]
sprężyna	[sprɛ̃ˈʐɨna]
pomarańcza	[pɔmaˈraɲt͡ʂa]
niebo	[ˈɲɛbɔ]
niebiosa	[ɲɛˈbjɔsa]
umieć	[ˈumʲɛt͡ɕ]
kwaśny	/ˈkfaɕnɨ/
kwaśna	/ˈkfaɕna/
kwaśne	/ˈkfaɕnɛ/
Meksyk	/ˈmɛksɨk/
lekarstwo	[lɛˈkarstfɔ]
druga	[ˈd̪ruɡä]
holenderski	/xɔlɛn̪ˈd̪ɛrs̪kʲi/
lakoniczny	[lakɔˈɲit͡ʂnɨ]
albański	[alˈbãĩ̯s̪ʲkʲi]
Kostaryka	/kɔstaˈrɨka/
fabryka	[ˈfa.brɨ.ka]
zielona	/ʑɛˈlɔn̪a/
zieleń	[ʑɛlɛɲ]
srebrne	/ˈs̪rɛbrn̪ɛ/
królowa	[kruˈlɔva]
caryca	[t͡saˈrɨt͡sa]
widzieć	/ˈvid͡ʑɛt͡ɕ/
mysz	[mɨʂ]
myszka	[ˈmɨʂka]
pokolenie	[pɔkɔˈlɛɲɛ]
przyroda	[pʂɨˈrɔda]
duński	[ˈd̪ũĩ̯s̪ʲkʲi]
bateria	/baˈt̪ɛrja/
czeski	[ˈt͡ʂɛs̪kʲi]
wielobok	[vʲɛˈlɔbɔk]
wody	[ˈvɔd̪ɨ]
podlewać	/pɔˈdlɛvat͡ɕ/
rycerz	[ˈrɨt͡sɛʂ]
fiut	/fjut/
zwierzęcy	/z̪vjɛˈʐɛn̪t͡s̪ɨ/
zwierzęca	/z̪vjɛˈʐɛn̪t͡s̪a/
zwierzęce	/z̪vjɛˈʐɛn̪t͡s̪ɛ/
koniec	/ˈkɔɲɛt͡s/
karaluch	[kaˈralux]
betonowy	/bɛt̪ɔˈn̪ɔvɨ/
powietrze	/pɔˈvjɛt.ʂɛ/
odpowiedź	[ɔtˈpɔwjɛt͡ɕ]
który	[ˈkturɨ]
która	[ˈkt̪ura]
które	[ˈkt̪urɛ]
jaka	[ˈjaka]
jakie	[ˈjacɛ]
zimny	[ˈʑimnɨ]
oziębły	[ɔˈʑɛmbwɨ]
nieprzygotowany	[ɲɛpʂɨɡɔtɔˈvanɨ]
zimno	/ˈʑimnɔ/
przeziębienie	[pʂɛʑɛmˈbʲɛɲɛ]
kciuk	/kt͡ɕuk/
afrykanerski	/afrɨkaˈn̪ɛrs̪kʲi/
róża	[ˈruʒa]
cynowy	[t͡sɨˈnɔwɨ]
ametystowy	/amɛt̪ɨˈs̪t̪ɔvɨ/
wiadro	/ˈvjadrɔ/
dźwięk	[d͡ʑvʲjɛ̃ŋk]
garść	/ɡarɕt͡ɕ/
siekiera	[ɕɛˈkʲɛra]
topór	[ˈtɔpur]
siła	[ˈɕiwa]
jednostka	/jɛˈdnɔstka/
puch	[pux]
dłoń	[d̪wɔ̃ɲ]
cukierek	[t͡suˈcɛrɛk]
ołów	[ˈɔwuf]
wskazywać	/fskaˈzɨvat͡ɕ/
wychodzić	[vɨˈxɔd͡ʑit͡ɕ]
wyjście	[ˈvɨjɕt͡ɕɛ]
smycz	[smɨt͡ʂ]
żar	[ʐar]
pożar	[ˈpɔʐar]
punkt	[pũŋkt̪]
peron	/ˈpɛrɔn/
gasi	[ˈɡaɕi]
litewski	[lʲiˈt̪ɛfs̪ʲci]
litr	[ˈlʲitr]
hektar	/ˈxɛkt̪ar/
korek	/ˈkɔrɛk/
kanasta	/kaˈnasta/
mało	/ˈmawɔ/
okup	[ˈɔkup]
bezczelność	[bɛsˈt͡ʂɛl.nɔɕt͡ɕ]
bezczelny	/bɛs̪ˈt͡ʂɛln̪ɨ/
aronia	[aˈrɔɲja]
faceta	[faˈt͡s̪ɛt̪a]
starsi	/ˈstarɕi/
wrona	[ˈvrɔna]
pasożyt	/paˈsɔʐɨt/
jesteś	[ˈjɛs̪t̪ɛɕ]
jesteśmy	/jɛsˈtɛɕmɨ/
jesteście	/jɛsˈtɛɕt͡ɕɛ/
są	[s̪ɔ̃w̃]
Angielka	[ãŋʲˈɡʲɛlka]
liczba	[ˈlʲid͡ʐba]
niemiecki	/ɲɛˈmjɛt͡s̪kʲi/
niewiele	/ɲɛˈvʲɛlɛ/
pokój	[ˈpɔkuj]
podatek	[pɔˈdatɛk]
otwarty	[ɔtˈfartɨ]
otwierać	[ɔˈtfjɛrat͡ɕ]
ostatni	/ɔˈstatɲi/
wczoraj	[ˈft͡ʂɔraj]
praca	/ˈprat͡s̪a/
pracować	[praˈt͡s̪ɔvat͡ɕ]
godzina	/ɡɔˈd͡ʑina/
otchłań	[ˈɔtxwaɲ]
pieniądz	/ˈpʲeˈɲɔnts͡/
zabijać	/zaˈbijat͡ɕ/
włoski	/ˈvwɔs̪kʲi/
młody	[ˈmwɔd̪ɨ]
równoległy	[ruvn̪ɔˈlɛɡwɨ]
szachy	[ˈʂaxɨ]
gówno	[ˈɡuvn̪ɔ]
srać	[srat͡ɕ]
ręka	[ˈrɛŋka]
mój	[muj]
nasz	[n̪aʂ]
przyszłość	/ˈpʂɨʂwɔɕt͡ɕ/
ilość	[ˈilɔɕt͡ɕ]
wschodni	/ˈfsxɔdɲi/
zachodni	/zaˈxɔdɲi/
teściowa	[tɛɕˈt͡ɕɔva]
bratowa	[braˈtɔva]
zięć	/ʑɛɲt͡ɕ/
synowa	[sɨˈnɔva]
owoc	[ˈɔvɔt͡s]
śliwka	[ˈɕlifka]
miedź	[mʲjet͡ɕ]
miedziany	/mjɛˈd͡ʑan̪ɨ/
pióro	/ˈpʲurɔ/
cytryna	/t͡s̪ɨˈt̪rɨn̪a/
nietoperz	[ɲeˈtɔ.pɛʂ]
myśleć	[ˈmɨɕlɛt͡ɕ]
wygląd	[ˈvɨɡlɔ̃n̪t̪]
włos	/vwɔs/
twarz	[tfaʂ]
bułgarski	/buwˈɡars̪kʲi/
kolej	[ˈkɔlɛj]
spać	[s̪pat͡ɕ]
myśl	[mɨɕl̥]
mokry	[ˈmɔkrɨ]
kształt	[kʂtawt]
grzebień	[ˈɡʐɛbjɛɲ]
suchy	[ˈs̪uxɨ]
żelazo	/ʐɛˈlazɔ/
żelazko	[ʐɛˈlas̪kɔ]
brzuch	[bʐux]
skrzypce	[ˈskʂɨpt͡sɛ]
sokół	[ˈs̪ɔkuw]
sowa	[ˈsɔva]
nornica	[nɔrˈɲit͡sa]
tryk	[trɨk]
kier	/kʲɛr/
ciemność	/ˈt͡ɕɛmnɔɕt͡ɕ/
śmierć	/ɕmjɛrt͡ɕ/
ciężki	/ˈt͡ɕɛw̃ʂkʲi/
żołądek	[ʐɔˈwɔ̃n̪d̪ɛk]
sztuka	[ˈʂt̪uka]
grać	/ɡrat͡ɕ/
pełny	[ˈpɛwn̪ɨ]
próżnia	[ˈpruʐɲa]
odkurzacz	[ɔtˈkuʐat͡ʂ]
odwaga	/ɔˈdvaɡa/
żyd	[ʐɨt]
Żyd	[ʐɨt]
Afryka	/ˈafrɨka/
socjalizm	/sɔˈt͡sjalizm/
orzech	/ˈɔʐɛx/
ogier	[ˈɔɡʲɛr]
amerykański	[ãmɛrɨˈkãĩ̯s̪ʲkʲi]
encyklopedia	[ɛn.t͡sɨ.klɔ.pɛˈdʲja]
synonim	[sɨˈnɔɲim]
orzeł	/ˈɔʐɛw/
obecnie	[ɔˈbɛt͡sɲɛ]
telefon komórkowy	/tɛˈlɛfɔn kɔmurˈkɔvɨ/
hiszpański	[xʲiˈʂpãĩ̯s̪ʲkʲi]
grecki	/ˈɡrɛt͡s̪kʲi/
islandzki	/iˈs̪lan̪t͡s̪kʲi/
zamykać	/ˈz̪amɨkat͡ɕ/
wiedzieć	/ˈvʲjɛd͡ʑɛt͡ɕ/
znać	[z̪n̪at͡ɕ]
kopyto	/kɔˈpɨtɔ/
podmiot	[ˈpɔdmjɔt]
temat	/ˈtɛmat/
przedmiot	/ˈpʂɛdmjɔt/
odpowiadać	[ɔt̪pɔˈvʲjad̪at͡ɕ]
zegarek	[zɛˈɡarɛk]
inside job	/ˌinsajd ˈd͡ʐɔp/
małpa	/ˈmawpa/
nosić	/ˈn̪ɔɕit͡ɕ/
papież	[ˈpapjɛʂ]
podkowa	[pɔtˈkɔva]
złodziej	[ˈz̪wɔd͡ʑej]
tramwaj	[ˈtram.vaj]
koperta	/kɔˈpɛrta/
zawód	[ˈzavut]
żaba	[ˈʐaba]
korzeń	/ˈkɔʐɛɲ/
sąsiad	[ˈsɔ̃ɕat]
głupek	[ˈɡwupɛk]
dżem	/d͡ʐɛm/
pieprz	[pʲɛpʂ]
strych	[strɨx]
samobójstwo	[samɔˈbujstfɔ]
samobójca	[samɔˈbujt͡sa]
kropka	/ˈkrɔpka/
okres	[ˈɔkrɛs]
mecz	[mɛt͡ʂ]
obiekt	[ˈobjɛkt]
alkoholowy	[alkɔxɔˈlɔvɨ]
bohater	[bɔˈxat̪ɛr]
lubić	/ˈlubʲit͡ɕ/
wampir	/ˈvampir/
Bahamy	/baˈxamɨ/
Bahrajn	/ˈbaxrajn/
Komory	/kɔˈmɔrɨ/
aksjomat	/aksˈjɔmat/
polityk	[pɔˈlʲit̪ɨk]
mejl	/mɛjl/
szminka	/ˈʂmin.ka/
mydło	[ˈmɨdwɔ]
Dominika	/dɔmiˈɲika/
Nikaragua	/ɲikaˈraɡua/
arbuz	[ˈarbus̪]
bagnet	[ˈbaɡnɛt]
rozwód	[ˈrɔzvut]
roztwór	[ˈrɔstfur]
leniwy	/lɛˈɲivɨ/
rozgwiazda	[rɔzˈɡvjazda]
patyna	[paˈtɨna]
chciwość	/ˈxt͡ɕivɔɕt͡ɕ/
wołacz	[ˈvɔwaʈ͡ʂ]
anglista	/aŋɡˈlis.ta/
Tajlandia	/t̪ajˈlan̪d̪ja/
zapominać	[zapɔˈminat͡ɕ]
słonecznik	[swɔˈnɛt͡ʂɲik]
wiadomość	[vʲjaˈd̪ɔ̃mɔɕt͡ɕ]
algorytm	/alˈɡɔɾɨtm/
konewka	[kɔˈnɛfka]
feminizm	/fɛˈmiɲizm/
błoto	[ˈbwɔtɔ]
rewolucja	[rɛvɔˈlut͡sja]
obietnica	[ɔbjɛtˈɲit͡sa]
obiecać	[ɔˈbjɛt͡sat͡ɕ]
rewolwer	[rɛˈvɔlvɛr]
śledź	/ɕlɛt͡ɕ/
kocioł	[ˈkɔt͡ɕɔw]
sumienie	[suˈmʲɛɲɛ]
Szwed	/ʂfɛt̪/
antologia	[ãn̪t̪ɔˈlɔɟja]
kac	[kat͡s]
szkło	/ʂkwɔ/
krew	[krɛf]
ludzie	[ˈlud͡ʑɛ]
nawet	/ˈnavɛt/
kolanowy	/kɔlaˈn̪ɔvɨ/
piasek	/ˈpʲjäsɛk/
kijanka	/kiˈjanka/
namiot	[ˈnamʲɔt]
kolorowy	/kɔlɔˈrɔvɨ/
żółtawy	/ʐuwˈtavɨ/
kamień	[ˈkãmʲjẽɲ]
skała	[ˈskawa]
inkunabuł	/inkunabuw/
tym	[t̪ɨ̃m]
miał	[mʲjaw]
było	/ˈbɨwɔ/
wieś	/ˈvʲɛɕ/
tłumaczenie	[t̪wũmaˈt͡ʂɛ̃ɲɛ]
lakmus	/ˈlakmus/
kochać	/ˈkɔxat͡ɕ/
Rosja	/ˈrɔsja/
Mołdawia	/mɔwˈdavja/
dziura	[ˈd͡ʑura]
otwór	[ˈɔtfur]
kwota	/ˈkfɔta/
Dorota	/d̪ɔˈrɔt̪a/
węgorz	[ˈvɛ̃ŋɡɔʂ]
czwarty	/ˈt͡ʂfartɨ/
piąty	[ˈpʲjɔ̃ntɨ]
szósty	[ˈʂustɨ]
siódmy	/ˈɕudmɨ/
ósmy	/ˈusmɨ/
dziewiąty	[d͡ʑɛˈvʲjɔ̃ntɨ]
dziesiąty	[d͡ʑɛˈɕɔ̃ntɨ]
jedenasty	[jɛdɛˈnastɨ]
dwunasty	[dvuˈnastɨ]
trzynasty	/t.ʂɨˈnastɨ/
czternasty	/t͡ʂtɛrˈnastɨ/
piętnasty	[pʲjɛtˈnastɨ]
szesnasty	/ʂɛsˈnastɨ/
siedemnasty	[ˌɕɛdɛmˈnastɨ]
osiemnasty	[ɔɕɛmˈnastɨ]
dziewiętnasty	[d͡ʑɛvʲjɛtˈnastɨ]
dwudziesty	[dvuˈd͡ʑɛstɨ]
trzydziesty	/t.ʂɨˈd͡ʑɛstɨ/
czterdziesty	/t͡ʂtɛrˈd͡ʑɛstɨ/
pięćdziesiąty	/pjɛɲd͡ʑɛˈɕɔntɨ/
sześćdziesiąty	/ʂɛʑd͡ʑɛˈɕɔntɨ/
siedemdziesiąty	/ɕɛdɛmd͡ʑɛˈɕɔntɨ/
osiemdziesiąty	/ɔɕɛmd͡ʑɛˈɕɔntɨ/
dziewięćdziesiąty	/d͡ʑɛvjɛɲd͡ʑɛˈɕɔntɨ/
setny	/ˈsɛtnɨ/
tysięczny	/tɨˈɕɛnt͡ʂnɨ/
milionowy	[mʲilʲjɔˈnɔvɨ]
gęś	[ˈɡɛ̃ɕ]
pornograf	[pɔrˈn̪ɔɡraf]
znaczyć	[ˈznat͡ʂɨt͡ɕ]
różny	[ˈruʐnɨ]
inny	/ˈin̪n̪ɨ/
inny	[ˈĩn̪n̪ɘ̟]
jądro	[ˈjɔ̃n̪d̪rɔ]
osioł	[ˈɔɕɔw]
życie	[ˈʐɨt͡ɕɛ]
iść	[iɕt͡ɕ]
chodzić	[ˈxɔd͡ʑit͡ɕ]
ogród	[ˈɔɡrut̪]
przysłówek	/pʂɨˈswuvɛk/
żyć	[ʐɨt͡ɕ]
mieszkać	[ˈmʲɛʂkat͡ɕ]
żagiel	/ˈʐaɟɛl/
Duńczyk	[ˈd̪ũĩ̯nt͡ʂɨk]
Dunka	/ˈd̪un̪ka/
adwokat	[ad̪ˈvɔkat̪]
morela	/mɔˈrɛla/
Ameryka	[aˈmɛrɨka]
kierowca	/cɛˈrɔft͡sa/
sterownik	[stɛˈrɔvɲik]
reszta	[ˈrɛʂta]
palacz	[ˈpalat͡ʂ]
skok	[s̪kɔk]
prowansalski	/prɔvanˈsalski/
kelner	[ˈkɛln̪ɛr]
więzienie	[vʲjẽĩ̯ˈʑẽɲɛ]
chwast	[xfast]
burdel	[ˈburd̪ɛl]
Bóg	[buk]
wiele	/ˈvʲɛlɛ/
organizm	[ɔrˈɡãɲis̪m̥]
Katarzyna	/kat̪aˈʐɨn̪a/
kuzyn	[ˈkuzɨn]
nadgarstek	/nadˈɡarstɛk/
krzesło	[ˈkʂɛs̪wɔ]
dotyk	[ˈdɔtɨk]
płakać	[ˈpwakat͡ɕ]
zdanie	[ˈzdaɲɛ]
sześcian	[ˈʂɛɕt͡ɕan]
butelka	[buˈt̪ɛlka]
biedny	[ˈbʲjɛd̪n̪ɨ]
posiłek	[pɔˈɕiwɛk]
szach	[ʂax]
pytanie	/pɨˈtaɲɛ/
weterynarz	/vɛtɛˈrɨnaʂ/
naród	[ˈnarut]
walka	[ˈvalka]
cierpieć	[ˈt͡ɕɛrpʲɛt͡ɕ]
kosmopolita	[kɔsmɔpɔˈlita]
Krym	/krɨm/
Norweg	[ˈnɔrvɛk]
kontynent	[kɔnˈtɨnɛnt]
możliwy	[mɔˈʐlʲivɨ]
bumerang	[bũˈmɛrãŋk]
gramatyka	[ɡraˈmatɨka]
komórka	/kɔˈmurka/
wątroba	/vɔn̪ˈt̪rɔba/
blisko	/ˈbliskɔ/
wirtualny	/virt̪uˈaln̪ɨ/
Henryk	/ˈxɛn̪rɨk/
widły	[ˈvidwɨ]
rozwidlenie	[rɔzviˈdlɛɲɛ]
kapelusz	[kaˈpɛluʂ]
aspekt	/ˈaspɛkt/
Chińska Republika Ludowa	[ˈçiɲska rɛpuˈblʲika luˈdɔva]
picie	[ˈpʲit͡ɕɛ]
ciocia	[ˈt͡ɕɔt͡ɕa]
kuzynka	[kuˈzɨnka]
teść	[tɛɕt͡ɕ]
anioł	/ˈaɲɔw/
dzwon	/d͡zvɔn̪/
przysięgać	[pʂɨˈɕɛŋɡat͡ɕ]
perski	[ˈpɛrs̪ʲkʲi]
gazeta	[ɡaˈz̪ɛt̪a]
krzyżówka	/kʂɨˈʐufka/
taczka	[ˈtat͡ʂka]
gąsienica	[ɡɔ̃ĩ̯ɕɛ̃ˈɲit͡s̪a]
zupa	/ˈzupa/
strażak	/ˈstraʐak/
urząd	[ˈuʐɔnt]
taniec	[ˈtaɲɛt͡s]
gracz	[ɡrat͡ʂ]
pragnienie	/praˈɡɲɛɲɛ/
wulkan	[ˈvulkãn̪]
klej	[klɛj]
początek	[pɔˈt͡ʂɔ̃tɛk]
księgarnia	[kʲɕɛ̃ŋˈɡarʲɲa]
małżeństwo	[mawˈʐɛ̃ĩ̯s̪t̪fɔ]
dziecko	[ˈd͡ʑɛt͡skɔ]
macocha	[maˈt͡sɔxa]
pasierb	[ˈpaɕɛrp]
pasierbica	[paɕɛrˈbit͡sa]
ojczym	[ˈɔjt͡ʂɨm]
dużo	/ˈduʐɔ/
robak	[ˈrɔbak]
trawa	/ˈtrava/
skóra	[ˈs̪kura]
mięso	[ˈmʲjɛ̃(w̃)s̪ɔ]
tłuszcz	[twuʂt͡ʂ]
róg	[ruk]
skrzydło	[ˈskʂɨ.dwɔ]
szyja	[ˈʂɨja]
księżyc	/ˈkʲɕɛw̃ʐɨt͡s/
rzeka	[ˈʐɛka]
ziemia	[ˈʑɛmja]
popiół	/ˈpɔpjuw/
jeśli	[ˈjɛɕli]
jeżeli	[jɛˈʐɛlʲi]
kynologia	[kɨ̃n̪ɔˈlɔɟja]
krocze	[krɔt͡ʂɛ]
później	[ˈpuʑɲɛ̝j]
pokazać	/pɔˈkazat͡ɕ/
Ryga	/ˈrɨɡa/
wielki	[ˈvʲjɛlʲci]
szeroki	/ʂɛˈrɔkʲi/
gruby	[ˈɡrubɨ]
mały	[ˈmawɨ]
krótki	/ˈkrut̪kʲi/
wąski	[ˈvɔ̃s̪ʲkʲi]
cienki	[t͡ɕɛ̃ŋʲkʲi]
wesz	[vɛʂ]
paznokieć	/pazˈnɔkʲɛt͡ɕ/
kolano	/kɔˈlan̪ɔ/
wnętrzności	[vnɛˈ̃t.ʂnɔɕt͡ɕi]
zamarzać	[zaˈmarzat͡ɕ]
gryźć	[ɡrɨɕt͡ɕ]
owad	[ˈɔvat]
szwagier	[ˈʂfaɡʲɛr]
szwagierka	[ʂfaˈɡʲɛrka]
jeremiada	[jɛrɛˈmjada]
motyl	[ˈmɔt̪ɨl]
nocny	[ˈn̪ɔt͡s̪n̪ɨ]
Beata	/bɛˈat̪a/
skoro	/ˈskɔrɔ/
daru	[ˈdaru]
półtora	[puwˈtɔra]
półtorej	[puwˈtɔrɛj]
pół	[puw]
ćwierć	[t͡ɕfʲjɛrt͡ɕ]
spodnie	/ˈspɔdɲɛ/
światło	/ˈɕfʲjatwɔ/
miejsce	[ˈmjejst͡sɛ]
informacja	[infɔrˈmat͡sja]
zmiana	[ˈzmjana]
środek	[ˈɕrɔdɛk]
działanie	[ˈd͡ʑaˈwaɲɛ]
istnieć	/ˈis̪t̪ɲɛt͡ɕ/
natomiast	[naˈtɔmjast]
przypadek	/pʂɨˈpadɛk/
przypadek	[pʂɘˈpäd̪ɛk]
stanowić	/staˈnɔvit͡ɕ/
czyli	[ˈt͡ʂɨli]
badanie	/baˈdaɲɛ/
ruch	[rux]
żaden	[ˈʐad̪ɛ̃n̪]
znaleźć	[ˈznalɛɕt͡ɕ]
dlatego	/dlaˈtɛɡɔ/
więcej	[ˈvʲjɛ̃n̪t͡s̪ɛj]
ogół	[ˈɔɡuw]
zrobić	/ˈzrɔbʲit͡ɕ/
zacząć	/ˈzat͡ʂɔɲt͡ɕ/
lecz	[lɛt͡ʂ]
zajazd	[ˈzajast]
potem	/ˈpɔtɛm/
cosinus	[kɔˈsinus]
Śląsk	[ɕlɔ̃sk]
śląski	/ˈɕlõski/
śląski	[ˈɕlɔ̃s̪kʲi]
głównie	/ˈɡwuvɲɛ/
sytuacja	[sɨtuˈat͡sja]
warunek	[vaˈrunɛk]
własny	[ˈvwas̪n̪ɨ]
społeczny	[s̪pɔˈwɛt͡ʂn̪ɨ]
rzadko	[ˈʐat̪kɔ]
sitko	[ˈɕitkɔ]
wybór	[ˈvɨbur]
wybory	[vɨˈbɔrɨ]
jerzyk	/ˈjɛʐɨk/
wróbel	[ˈvrubɛl]
dzięcioł	/ˈd͡ʑɛɲt͡ɕɔw/
bocian	[ˈbɔt͡ɕan]
gołąb	[ˈɡɔwɔmp]
szpak	[ʂpak]
kanarek	/kaˈnarɛk/
kukułka	[kuˈkuwka]
struś	[struɕ]
pingwin	[ˈpiŋɡvin]
jaskółka	[jaˈskuwka]
kopciuszek	[kɔpˈt͡ɕuʂɛk]
zięba	[ˈʑɛmba]
sójka	[ˈs̪ujka]
sroka	[ˈsrɔka]
górnołużycki	/ɡurn̪ɔwuˈʐɨt͡s̪kʲi/
dolnołużycki	[d̪ɔln̪ɔwuˈʐɨt͡s̪kʲi]
słoweński	[s̪wɔˈvɛ̃ĩ̯s̪ʲkʲi]
słowacki	/s̪wɔˈvat͡s̪kʲi/
chorwacki	/xɔrˈvat͡s̪kʲi/
serbski	[ˈs̪ɛrps̪ʲkʲi]
Agata	/aˈɡat̪a/
rozumiem	/rɔˈzumjɛm/
chcę	[xt͡s̪ɛ]
żyję	[ˈʐɨjɛ]
śpiewam	[ˈɕpjɛvam]
robię	[ˈrɔbjɛ]
strona	[ˈstrɔna]
żeby	/ˈʐɛbɨ/
niż	[ɲiʂ]
stać	[st̪at͡ɕ]
może	/ˈmɔʐɛ/
leń	[lɛɲ]
chłop	/xwɔp/
przymiotnik	/pʂɨʼmʲjɔt̪ɲik/
sposób	[ˈspɔsup]
spójnik	[ˈspujɲik]
odmiana	[odˈmja.na]
żeński	[ˈʐɛ̃ĩ̯s̪ʲci]
postać	/ˈpɔs̪t̪at͡ɕ/
przedimek	/pʂɛˈd̪imɛk/
okulary	[ɔkuˈlarɨ]
plecy	/ˈplɛt͡sɨ/
imieniny	[imjɛˈɲinɨ]
kręgle	[ˈkrɛ̃ŋɡlɛ]
majtki	/ˈmajtci/
urodziny	[urɔˈd͡ʑinɨ]
nosze	[ˈn̪ɔʂɛ]
nożyczki	[nɔˈʐɨt͡ʂki]
rajstopy	[rajˈstɔpɨ]
sanki	/ˈs̪an̪kʲi/
słodycze	[swɔˈdɨt͡ʂɛ]
walentynki	[valɛnˈtɨnki]
zjeść	[zjɛɕt͡ɕ]
drukarnia	[ˈdruˈkarɲa]
drukarz	[ˈdrukaʂ]
drukować	[druˈkɔvat͡ɕ]
głupia	/ˈɡwupja/
głupie	/ˈɡwupjɛ/
plutonu	[pluˈtɔnu]
listonosz	/lis̪ˈt̪ɔn̪ɔʂ/
poczta	[ˈpɔt͡ʂta]
koktajl	[ˈkɔktajl]
mniejszość	[ˈmɲɛjʂɔɕt͡ɕ]
większość	[ˈvʲjɛ̃ŋkʂɔɕt͡ɕ]
dudy	/ˈdudɨ/
pojutrze	[pɔˈjut.ʂɛ]
przedwczoraj	/pʂɛtˈft͡ʂɔraj/
kuchnia	[ˈkuxɲa]
kuchenka	[kuˈxɛnka]
łazienka	[waˈʑɛnka]
piwnica	[piˈvɲit͡sa]
sypialnia	[sɨˈpjalɲa]
pralka	[ˈpralka]
lodówka	[lɔˈduf.ka]
suszarka	[suˈʂarka]
statek	[ˈstatɛk]
Kosowo	[kɔˈsɔvɔ]
Kosowianin	[kɔˈsɔwjaɲin]
kosowski	/kɔˈs̪ɔfs̪kʲi/
kalendarz	/kaˈlɛn.daʂ/
polszczyzna	[pɔlˈʂt͡ʂɨzna]
daktyl	[ˈd̪akt̪ɨl]
sód	[sut]
jedzenie	[jɛˈd͡zɛɲɛ]
Salwador	/salˈvadɔr/
następny	[n̪aˈs̪t̪ɛ̃mpn̪ɨ]
Japonka	[jaˈpɔnka]
japoński	[jaˈpɔ̃ĩ̯s̪ʲkʲi]
czerwień	[ˈt͡ʂɛrvjɛɲ]
Włoszka	[ˈvwɔʂka]
alfabety	/alfaˈbɛtɨ/
kwadrat	[ˈkfad̪rat̪]
kwadratowy	[kfadraˈtɔvɨ]
trapez	[ˈt̪rapɛs̪]
zbyt	[zbɨt]
wyłączyć	[vɨˈwɔnt͡ʂɨt͡ɕ]
plotka	[ˈplɔtka]
łańcuch	[ˈwaɲt͡sux]
sieć	[ɕɛt͡ɕ]
musztarda	[muʂˈtarda]
Rzym	/ʐɨm/
Poznań	/ˈpɔz̪n̪aɲ/
Pekin	/ˈpɛkʲin̪/
Lublin	/ˈlublin̪/
Lizbona	[liˈzbɔna]
środowisko	[ɕrɔdɔˈviskɔ]
niedźwiedzica	[ɲɛd͡ʑvʲjɛˈd͡ʑit͡sa]
ludzki	[ˈlut͡s̪kʲi]
walczyć	[ˈvalt͡ʂɨt͡ɕ]
eufemizm	[ɛwˈfɛ̃mʲis̪m̥]
przestępca	[pʂɛsˈtɛmpt͡sa]
idealny	/idɛˈalnɨ/
koszula	[kɔˈʂula]
substancja	[supˈstant͡sja]
guzik	[ˈɡuʑik]
piłka	[ˈpiwka]
kłębek	[ˈkwɛmbɛk]
jajo	/ˈjajɔ/
magnes	[ˈmaɡnɛs]
klawisz	[ˈklaviʂ]
nosorożec	[nɔsɔˈrɔʐɛt͡s]
brzoskwinia	/bʐɔsˈkfiɲa/
onanizm	[ɔˈnaɲizm]
gruszka	[ˈɡruʂka]
szczęśliwy	/ʂt͡ʂɛ̃ɕˈlivɨ/
szczęśliwy	/ʂt͡ʂɛw̃ɕˈlivɨ/
szczęśliwy	/ʂt͡ʂɛnɕˈlivɨ/
wierzyć	/ˈvʲɛʐɨt͡ɕ/
tamten	/ˈtamtɛn/
plik	[plʲik]
pomagać	/pɔˈmaɡat͡ɕ/
kopnięcie	/kɔpˈɲɛɲt͡ɕɛ/
naturalny	[natuˈralnɨ]
codziennie	[t͡sɔˈd͡ʑɛnɲɛ]
świt	[ɕfit]
gawron	[ˈɡavrɔn]
papieros	/paˈpjɛrɔs/
ameryk	[aˈmɛrɨk]
płeć	[pwɛt͡ɕ]
Chorwacja	[xɔrˈvat͡sja]
Słowenia	/s̪wɔˈvɛɲja/
Łotwa	[ˈwɔtfa]
funkcja	[ˈfuŋk.t͡sja]
należeć	[n̪aˈlɛʐɛt͡ɕ]
również	[ˈruvɲɛʂ]
sprawa	/ˈsprava/
dać	[d̪at͡ɕ]
Budapeszt	[buˈd̪apɛʂt̪]
właśnie	[ˈvwaɕɲɛ]
płaszczyzna	/pwaʂˈt͡ʂɨzna/
strzałka	[ˈst.ʂawka]
dziwny	[ˈd͡ʑivn̪ɨ]
pocałunek	[pɔt͡saˈwunɛk]
prostokąt	/prɔˈs̪t̪ɔkɔn̪t̪/
ezoteryczny	[ɛzɔtɛˈrɨt͡ʂnɨ]
macierz	[ˈmat͡ɕɛʂ]
powódź	[ˈpɔvut͡ɕ]
wykrzyknik	[vɨˈkʂɨkɲik]
gość	[ɡɔɕt͡ɕ]
pięciokąt	/pjɛɲˈt͡ɕɔkɔn̪t̪/
płuco	[ˈpwut͡sɔ]
jedyny	/jɛˈdɨnɨ/
czoło	[ˈt͡ʂɔwɔ]
Tomasz	/ˈt̪ɔmaʂ/
arcybiskup	[art͡sɨˈbiskup]
równanie	/ruvˈnaɲɛ/
sportowiec	/spɔrˈtɔvjɛt͡s/
soja	[ˈsɔja]
jarzmo	/ˈjaʐmɔ/
dentysta	/dɛnˈtɨsta/
czary	[ˈt͡ʂarɨ]
boru	/ˈbɔru/
otyłość	[ɔˈtɨwɔɕt͡ɕ]
krach	/ˈkrax/
śpiwór	[ˈɕpivur]
pietruszka	[pjɛˈtruʂka]
jabłoń	/ˈjabwɔɲ/
mrowisko	[mrɔˈviskɔ]
statuetka	[statuˈɛtka]
budować	[buˈdɔvat͡ɕ]
randka	[ˈrantka]
sznurek	[ˈʂnurɛk]
walizka	[vaˈlʲis̪ka]
pieniądze	[pʲjẽˈɲɔ̃n̪d͡zɛ]
pieniądze	[pʲĩˈɲɔ̃n̪d͡zɛ]
gdy	[ɡdɨ]
jakiś	[ˈjaciɕ]
też	[tɛʂ]
zostać	/ˈzɔstat͡ɕ/
Gujana	/ɡuˈjana/
darmsztadt	/ˈdarmʂtat/
obowiązek	[ɔbɔˈvjɔnzɛk]
cło	[t͡swɔ]
bitwa	/ˈbitfa/
Krzysztof	[ˈkʂɨʂt̪ɔf]
kanał	/ˈkan̪aw/
złotnik	[ˈz̪wɔt̪ʲɲik]
spojówka	/spɔˈjufka/
ablacja	/aˈblat͡s̪ja/
opieka	[ɔˈpʲɛka]
młodość	/ˈmwɔdɔɕt͡ɕ/
jagnię	[ˈjaɡʲɲɛ]
śmiech	/ˈɕmjɛx/
uśmiech	[ˈuɕmjɛx]
czapla	[ˈt͡ʂapla]
ślimak	/ˈɕlimak/
Alpy	[ˈalpɨ]
Tatry	[ˈtatrɨ]
Himalaje	[ximaˈlajɛ]
Pireneje	[pirɛˈnɛjɛ]
Karpaty	[karˈpatɨ]
Sudety	[suˈdɛtɨ]
pająk	[ˈpajɔ̃ŋk]
płaz	[pwas]
potwór	[ˈpɔtfur]
każda	[ˈkaʐd̪a]
każde	[ˈkaʐd̪ɛ]
żmija	[ˈʐmʲija]
ssak	/sːak/
trzmiel	[t.ʂmʲjɛl]
ważka	[ˈvaʂka]
świerszcz	[ɕfjɛrʂt͡ʂ]
szarańcza	[ʂaˈraɲt͡ʂa]
sardynka	[sarˈdɨnka]
latarka	/laˈtarka/
ławka	[ˈwafka]
krokodyl	/krɔˈkɔdɨl/
nowość	[ˈnɔvɔɕt͡ɕ]
puchacz	/ˈpuxat͡ɕ/
gej	[ɡɛj]
lesbijka	[lɛzˈbij.ka]
dyrygent	[dɨˈrɨɡɛnt]
przewodnik	[pʂɛˈvɔdɲik]
dzielić	[ˈd͡ʑɛlʲit͡ɕ]
meczet	/ˈmɛt͡ʂɛt/
szacunek	[ʂaˈt͡sunɛk]
podeszwa	[pɔˈdɛʂfa]
Sardynia	[sarˈdɨɲa]
skrzypek	[ˈskʂɨpɛk]
poświęcenie	[pɔɕfʲɛnˈt͡sɛɲɛ]
piosenkarz	/pjɔˈsɛnkaʂ/
popielniczka	[pɔpʲɛlˈɲit͡ʂka]
prysznic	[ˈprɨʂɲit͡s]
obój	[ˈobuj]
odbudować	/ɔdbuˈdɔvat͡ɕ/
koliber	[kɔˈlʲibɛr]
sikora	[ɕiˈkɔra]
Lew	[lɛf]
kraść	/kraɕt͡ɕ/
próba	[ˈpruba]
krawat	[ˈkravat]
przedstawienie	/pʂɛtstaˈvjɛɲɛ/
łopata	[wɔˈpata]
koszykówka	/kɔʂɨˈkufka/
wielkość	[ˈvʲɛlkɔɕt͡ɕ]
szum	[ʂum]
konstytucja	[kɔnstɨˈtut͡sja]
kapłan	[ˈkapwan]
ksiądz	/kʲɕɔn̪t͡s̪/
kłamstwo	/ˈkwamstfɔ/
dekada	/dɛˈkada/
wojsko	[ˈvɔjskɔ]
przeszłość	/ˈpʂɛʂwɔɕt͡ɕ/
maszyna	/maˈʂɨna/
autonomiczny	/awt̪ɔn̪ɔˈmit͡ʂn̪ɨ/
oblicze	[ɔˈblit͡ʃɛ]
bekon	/ˈbɛkɔn̪/
świerk	/ɕfʲɛrk/
choinka	/xɔˈiŋkä/
komercjalizacja	[kɔmɛrt͡sjaliˈzat͡sja]
dekomercjalizacja	[dɛkɔmɛrt͡sjaliˈzat͡sja]
rdza	[ˈrd͡za]
misja	/ˈmisja/
aukcja	[ˈawkt͡sja]
animacja	[aɲiˈma.t͡sʲja]
inflacja	/inˈflat͡sja/
deflacja	[dɛˈflat͡sja]
kąt	/kɔn̪t̪/
informatyka	[infɔrˈmatɨka]
artykulacja	[artɨkuˈlat͡sja]
fonologia	[fɔnɔˈlɔɡʲa]
fonetyka	[fɔˈnɛtɨka]
lingwistyka	[liŋɡˈvistɨka]
językoznawstwo	/jɛ̃zɨkɔˈznafstfɔ/
optyka	[ˈɔptɨka]
optyka	[ɔpˈtɨka]
optyk	[ˈɔpt̪ɨk]
palatalizacja	[palataliˈzat͡sja]
depalatalizacja	[dɛpalataliˈzat͡sja]
dyspalatalizacja	[dɨspalataliˈzat͡sja]
Libia	[ˈlʲibʲa]
śmietana	/ɕmjɛˈt̪an̪a/
kardynał	[karˈdɨnaw]
siarka	[ˈɕarka]
restauracja	[rɛstawˈrat͡sja]
telewizja	[tɛlɛˈvizja]
przygoda	[pʂɨˈɡɔda]
świeca	[ˈɕfʲɛt͡sa]
żyrandol	[ʐɨˈrandɔl]
cipa	[ˈt͡ɕipa]
erudycja	[ɛruˈdɨt͡sja]
Erywań	[ɛˈrɨvaɲ]
nektar	[ˈnɛktar]
maść	[maɕt͡ɕ]
barwa	[ˈbarva]
dłuto	/ˈdwutɔ/
dół	/d̪uw/
materac	[maˈtɛrat͡s]
przystanek	[pʂɨˈstanɛk]
szyna	/ˈʂɨna/
szynka	[ˈʂɨnka]
pasażer	/paˈsaʐɛr/
motorniczy	/mɔtɔrˈɲit͡ʂɨ/
sejf	[sɛjf]
Owczarkowski	[ɔft͡ʂarˈkɔfski]
czasu	[ˈt͡ʂas̪u]
czasie	[ˈt͡ʂaɕɛ]
miedziana	[mʲɛˈd͡ʑana]
miedziane	[mʲɛˈd͡ʑanɛ]
naturalna	[natuˈralna]
naturalne	[natuˈralnɛ]
przygotowany	[pʂɨɡɔtɔˈvanɨ]
nowe	[ˈnɔvɛ]
otwarta	[ɔtˈfarta]
otwarte	[ɔtˈfartɛ]
zamknięty	/z̪amˈkʲɲɛn̪t̪ɨ/
zamknięta	[zamˈkɲɛnta]
zamknięte	[zamˈkɲɛntɛ]
nudny	/ˈnudnɨ/
nudna	[ˈnudna]
nudne	[ˈnudnɛ]
cały	[ˈt͡sawɨ]
cała	[ˈt͡sawa]
ciotka	[ˈt͡ɕɔt̪ka]
dolny	[ˈdɔlnɨ]
narzeczona	[naʐɛˈt͡ʂɔna]
narzeczony	[naʐɛˈt͡ʂɔnɨ]
powiat	[ˈpɔvʲjat̪]
wnuczka	/ˈvnut͡ʂka/
fiński	[ˈfʲĩĩ̯s̪ʲkʲi]
węgierski	[vɛ̃ŋˈɡʲɛrs̪ʲkʲi]
irlandzki	/irˈlan̪t͡s̪kʲi/
łotewski	/wɔˈt̪ɛfs̪kʲi/
szwedzki	/ˈʂfɛt͡s̪ci/
malować	/maˈlɔvat͡ɕ/
afrykański	[afrɨˈkãĩ̯s̪ʲkʲi]
azjatycki	/az̪jaˈt̪ɨt͡s̪kʲi/
Azja	/ˈaz̪ja/
australijski	[aws̪t̪raˈlʲijs̪ʲkʲi]
australijskie	/awstraˈlijskʲɛ/
europejski	/ɛwrɔˈpɛjs̪kʲi/
dolna	[ˈdɔlna]
dolne	[ˈdɔlnɛ]
górna	[ˈɡurna]
górne	[ˈɡurnɛ]
stacja	[ˈstat͡sja]
wybuch	[ˈvɨbux]
eksplozja	[ɛksˈplɔzja]
implozja	[imˈplɔzja]
lawina	/laˈvina/
wodny	[ˈvɔdnɨ]
podwodny	[pɔdˈvɔdnɨ]
podwodna	[pɔdˈvɔdna]
podwodne	[pɔdˈvɔdnɛ]
np.	[naˈpʂɨkwat]
arabski	[aˈraps̪ʲkʲi]
fajny	/ˈfajnɨ/
grzeczny	[ˈɡʐɛt͡ʂnɨ]
niegrzeczny	[ɲɛˈɡʐɛt͡ʂnɨ]
niegrzeczna	[ɲɛˈɡʐɛt͡ʂna]
niegrzeczne	[ɲɛˈɡʐɛt͡ʂnɛ]
niegrzeczni	[ɲɛˈɡʐɛt͡ʂɲi]
indoeuropejski	/in̪d̪ɔɛwrɔˈpɛjs̪kʲi/
praindoeuropejski	/praindɔewrɔˈpɛjski/
reportaż	[rɛˈpɔrtaʂ]
witraż	[ˈvitraʂ]
majonez	[maˈjɔ.nɛs]
fotel	[ˈfɔtɛl]
fontanna	[fɔnˈtanːa]
perfumy	[pɛrˈfumɨ]
kulon	[ˈkulɔn]
erotyczny	[ɛrɔˈtɨt͡ʂnɨ]
telefoniczny	[tɛlɛfɔˈɲit͡ʂnɨ]
specjalny	[spɛˈt͡sjalnɨ]
specjalna	[spɛˈt͡sjalna]
specjalne	[spɛˈt͡sjalnɛ]
szybki	[ˈʂɨpʲkʲi]
szybka	[ˈʂɨpka]
szybkie	[ˈʂɨpkʲɛ]
szybcy	/ˈʂɨpt͡sɨ/
sojusz	[ˈsɔjuʂ]
głodny	[ˈɡwɔd̪n̪ɨ]
głodna	/ˈɡwɔdna/
głodne	/ˈɡwɔdnɛ/
głodni	/ˈɡwɔdɲi/
głód	[ɡwut̪]
masochista	/masɔˈxista/
bieługa	[bʲɛˈwuɡa]
hebrajski	/xɛˈbrajs̪kʲi/
spragniony	[spraˈɡɲɔnɨ]
zdrowy	[ˈzd̪rɔvɨ]
zdrowa	[ˈzdrɔva]
zdrowe	[ˈzdrɔvɛ]
pasieka	[paˈɕɛka]
zmęczony	[z̪mɛ̃nˈt͡ʂɔ̃n̪ɨ]
zmęczona	[zmɛ̃ˈt͡ʂɔna]
zmęczone	[zmɛ̃ˈt͡ʂɔnɛ]
zmęczeni	[zmɛ̃ˈt͡ʂɛɲi]
ciekawy	[t͡ɕɛˈkavɨ]
nieciekawy	[ɲɛt͡ɕɛˈkavɨ]
szef	/ʂɛf/
pensja	/ˈpɛ̃sja/
chomik	[ˈxɔmik]
Adelajda	/ad̪ɛˈlajd̪a/
dżokej	[ˈd͡ʐɔkɛj]
stres	[ˈstrɛs]
skuter	[ˈskutɛr]
bobslej	[ˈbɔps̪lɛj]
strajk	[ˈstrajk]
zgniły	[ˈzɡɲiwɨ]
okrągły	[ɔˈkrɔ̃ŋɡwɨ]
ostry	[ˈɔs̪t̪rɨ]
tępy	[ˈt̪ɛmpɨ]
poprawny	[pɔˈpravnɨ]
prawidłowy	[praviˈdwɔvɨ]
daleki	[d̪aˈlɛkʲi]
dalecy	/daˈlɛt͡sɨ/
Polak	[ˈpɔlak]
katar	[ˈkatar]
wojna	[ˈvɔjna]
krzyk	[kʂɨk]
p.n.e.	/pʂɛt naʂɔ̃ ɛrɔ̃/
królik	[ˈkrulik]
deser	[ˈdɛsɛr]
szarlotka	[ʂarˈlɔtka]
burmistrz	[ˈbur.mistʂ]
makijaż	/maˈkijaʂ/
komoda	[kɔˈmɔda]
wezyr	[ˈvɛzɨr]
chałwa	[ˈxawva]
łydka	[ˈwɨtka]
łuk	[wuk]
wątek	/ˈvɔn̪t̪ɛk/
uczciwy	[ut͡ʂˈt͡ɕivɨ]
dupek	[ˈdupɛk]
nieuczciwy	[ɲɛut͡ʂˈt͡ɕivɨ]
programista	/prɔɡraˈmista/
kaszubski	/kaˈʂups̪kʲi/
promień	[ˈprɔmʲɛɲ]
alergia	[aˈlɛrʲɟja]
meble	[ˈmɛblɛ]
egzotyczny	[ɛɡzɔˈtɨt͡ʂnɨ]
głośny	[ˈɡwɔɕnɨ]
itp.	/i tɨm pɔdɔbnɛ/
głuchy	[ˈɡwuxɨ]
dziki	/ˈd͡ʑikʲi/
mądry	[ˈmɔndrɨ]
silny	[ˈɕiln̪ɨ]
słaby	[ˈs̪wabɨ]
wesoły	[vɛˈsɔwɨ]
krzepki	/ˈkʂɛpkʲi/
świeży	[ˈɕfʲɛʐɨ]
święty	[ˈɕfʲjɛ̃n̪t̪ɨ]
trzeźwy	[ˈt.ʂɛʑvɨ]
siwy	[ˈɕivɨ]
miękki	[ˈmʲjɛ̃ŋʲkʲːi]
gorzki	/ˈɡɔʂkʲi/
budżet	[ˈbud.ʐɛt]
budżet	[ˈbud͡ʐ.ʐɛt]
reżyser	[rɛˈʐɨsɛr]
częsty	[ˈt͡ʂɛ̃stɨ]
głęboki	/ɡwɛmˈbɔkʲi/
niski	[ˈɲis̪ʲci]
równy	[ˈruvnɨ]
rzadki	/ˈʐat̪kʲi/
szakal	/ˈʂakal/
wodór	[ˈvɔdur]
węgiel	[ˈvɛ̃ŋʲɟɛl]
wapń	[vapʲɲ̊]
rtęć	[r̥t̪ɛ̃ɲt͡ɕ]
chlor	/xlɔr/
krzem	/kʂɛm/
błąd	[bwɔ̃n̪t̪]
gniew	/ɡɲɛf/
pamięć	[ˈpãmʲjẽɲt͡ɕ]
wymiana	[vɨˈmʲana]
sąd	[sɔnt]
wina	[ˈvʲĩn̪a]
bieda	/ˈbʲɛda/
bawół	/ˈbavuw/
wiewiórka	[vʲɛˈvʲurka]
żuk	[ʐuk]
świnia	/ˈɕfiɲa/
sęp	[sɛmp]
słowik	[ˈswɔvik]
czajka	[ˈt͡ʂajka]
dąb	/dɔmp/
dęby	/ˈdɛmbɨ/
sosna	[ˈsɔsna]
wróg	[vruk]
wejść	[vɛjɕt͡ɕ]
waluta	[vaˈlut̪a]
przysłowie	[pʂɨˈswɔvʲɛ]
wyjść	[vɨjɕt͡ɕ]
pływać	[ˈpwɨvat͡ɕ]
dowód	[ˈd̪ɔvut̪]
inteligencja	/intɛliˈɡɛnt͡sja/
lew	[lɛf]
wąwóz	/ˈvɔ̃vus/
emocja	[ɛmɔt͡sja]
łódź	[ˈwut͡ɕ]
myć	[mɨt͡ɕ]
oś	[ɔɕ]
siodło	[ˈɕɔdwɔ]
wełna	[ˈvɛwna]
wosk	[vɔsk]
myszołów	[mɨˈʂɔwuf]
przepiórka	[pʂɛˈpʲurka]
ryś	[rɨɕ]
dżdżownica	[d͡ʐd͡ʐɔˈvɲit͡sa]
dżentelmen	[ˈd͡ʐɛntɛlmɛn]
dżersej	[ˈd͡ʐɛrsɛj]
dżez	[d͡ʐɛs]
dżezowy	[d͡ʐɛˈzɔvɨ]
dżezbend	[ˈd͡ʐɛzbɛnt]
dżezmen	[ˈd͡ʐɛzmɛn]
dżin	[ˈd͡ʒin]
dżinn	[ˈd͡ʒin]
dżinsy	[ˈd͡ʒinsɨ]
dżudo	[ˈd͡ʐudɔ]
dżudoczka	[d͡ʐuˈdɔt͡ʂka]
dżudoka	[d͡ʐuˈdɔka]
szubienica	[ʂubʲɛˈɲit͡sa]
Szwedka	[ˈʂfɛt̪ka]
głęboko	[ɡwɛmˈbɔkɔ]
Dżakarta	[d͡ʐaˈkarta]
Dżibuti	[d͡ʒiˈbuti]
dawać	[ˈdavat͡ɕ ]
równoczesny	[ruvnɔˈt͡ʂɛsnɨ]
jednoczesny	[jɛdnɔˈt͡ʂɛsnɨ]
ciężarówka	/t͡ɕɛ̃ʐaˈrufka/
samogłoska	[samɔˈɡwɔska]
spółgłoska	[spuwˈɡwɔska]
bym	[bɨm]
byś	[bɨɕ]
byśmy	[ˈbɨɕmɨ]
byście	[ˈbɨɕt͡ɕɛ]
dżihad	[ˈd͡ʒixat]
dżul	[d͡ʐul]
dżuma	[ˈd͡ʐuma]
dżungla	[ˈd͡ʐũŋɡla]
wschód	[fs̪xut̪]
zachód	/ˈzäxut/
zwykle	/ˈzvɨklɛ/
zwykły	/ˈzvɨkwɨ/
centymetr	[t͡s̪ɛ̃n̪ˈt̪ɨmɛt̪r̥]
zazdrość	[ˈz̪az̪d̪rɔɕt͡ɕ]
rozmowa	[rɔzˈmɔva]
budowla	[buˈdɔvla]
poziomka	/pɔˈʑɔmka/
śmieciarka	[ɕmʲjeˈt͡ɕar.ka]
koparka	/kɔˈparka/
czołg	[t͡ʂɔwk]
samochody	/samɔˈxɔdɨ/
lwica	[ˈlvʲit͡s̪a]
leżeć	[ˈlɛʐɛt͡ɕ]
stąd	[s̪t̪ɔ̃n̪t̪]
czereśnia	[t͡ʂɛˈrɛɕɲa]
wiśnia	/ˈviɕɲa/
wiśniowy	[viˈɕɲɔvɨ]
grejpfrut	[ˈɡrɛjpfrut]
ciągnik	[ˈt͡ɕɔ̃ŋɡʲɲik]
taksówka	[taˈksufka]
skąd	[s̪kɔ̃n̪t̪]
Argentyna	/arɡɛnˈtɨna/
zakupy	[zaˈkupɨ]
optymista	[ɔptɨˈmista]
optymistka	[ɔptɨˈmistka]
pesymistka	[pɛsɨˈmistka]
pesymista	[pɛsɨˈmista]
święto	/ˈɕfjɛ̃ntɔ/
Magda	/ˈmaɡda/
jedenaście	/jɛd̪ɛˈn̪aɕt͡ɕɛ/
miąższ	/mʲɔ̃ʂ/
jadalny	[jaˈdalnɨ]
niejadalny	[ɲɛjaˈdalnɨ]
czasem	/ˈt͡ʂasɛm/
czasami	/t͡ʂaˈsami/
mandarynka	[mandaˈrɨnka]
białoruski	/bjawɔˈruskʲi/
przyjść	[ˈpʂɨjɕt͡ɕ]
dodatek	[dɔˈdatɛk]
dyskusja	/d̪ɨs̪ˈkus̪ja/
żebro	/ˈʐɛbrɔ/
żyrafa	/ʐɨˈrafa/
żołnierz	/ˈʐɔwɲɛʂ/
szlafrok	/ˈʂlafrɔk/
szantaż	[ˈʂantaʂ]
bośniacki	/bɔˈɕɲat͡s̪kʲi/
chiński	[ˈçiɲs̪ci]
fryzyjski	[frɨˈz̪ɨjs̪ʲkʲi]
kurdyjski	/kurˈd̪ɨjs̪kʲi/
mongolski	[mɔ̃ŋˈɡɔlsʲkʲi]
szkocki	[ˈʂkɔt͡s̪ʲkʲi]
tajski	/ˈt̪ajs̪kʲi/
tajlandzki	/t̪ajˈlan̪t͡s̪kʲi/
turecki	/t̪uˈrɛt͡s̪kʲi/
ujgurski	/ujˈɡurs̪kʲi/
wietnamski	/vjɛt̪ˈn̪ams̪kʲi/
celtycki	/t͡s̪ɛlˈt̪ɨt͡s̪kʲi/
celtycka	/t͡sɛlˈtɨt͡ska/
celtyckie	/t͡sɛlˈtɨt͡skʲɛ/
celtyccy	/t͡sɛlˈtɨt͡st͡sɨ/
szwajcarski	[ʂfajˈt͡s̪ars̪ʲkʲi]
źle	[ʑlɛ]
ciemiernik	[t͡ɕɛ̃ˈmʲjɛrʲɲik]
ciekawie	[t͡ɕɛˈkavʲɛ]
zajęty	/z̪aˈjɛn̪t̪ɨ/
tańczyć	[ˈt̪ãĩ̯nt͡ʂɨt͡ɕ]
igła	[ˈiɡwa]
jeże	[ˈjɛʐɛ]
jeżyk	[ˈjɛʐɨk]
żabka	[ˈʐapka]
rybka	[ˈrɨpka]
zęby	[ˈzɛmbɨ]
niedźwiadek	[ɲɛd͡ʑˈvʲadɛk]
hasło	[ˈxaswɔ]
premiera	[prɛˈmʲɛra]
przesada	/pʂɛˈsada/
wiązówka	/vjɔ̃ˈzufka/
grusza	/ˈɡruʂa/
kasztan	[ˈkaʂt̪ãn̪]
gryzoń	[ɡrɨzɔɲ]
szynszyla	[ʃɨ̃w̃ˈʃɨla]
budzik	[ˈbud͡ʑik]
wzrost	[vzrɔst]
spadek	[ˈspadɛk]
słuch	[swux]
słuchawki	[swuˈxafki]
puszczyk	[ˈpuʂt͡ʂɨk]
lub	/lup/
wracać	[ˈvrat͡s̪at͡ɕ]
nigdy	[ˈɲiɡdɨ]
dzieci	/ˈd͡ʑɛt͡ɕi/
źrenica	[ʑrɛˈɲit͡sa]
tęczówka	[t̪ɛ̃nˈt͡ʂufka]
rogówka	[rɔˈɡufka]
twardówka	/tfarˈdufka/
naczyniówka	[nat͡ʂɨˈɲufka]
dziś	[d͡ʑiɕ]
wziąć	/vʑɔɲt͡ɕ/
kłaść	[kwaɕt͡ɕ]
tłum	/twum/
marnować	/marn̪ˈɔvat͡ɕ/
szansa	/ˈʂaw̃s̪a/
dodawać	/d̪ɔˈd̪avat͡ɕ/
Byk	bɨk
Bliźnięta	[blʲiˈʑɲɛ̃n̪t̪a]
soczewka	[sɔˈt͡ʂɛfka]
woskówka	/vɔsˈkufka/
węch	/vɛ̃x/
zapach	[ˈzapax]
kucharz	/ˈkuxaʂ/
półwysep	[puwˈvɨs̪ɛp]
historyk	/çisˈt̪ɔrɨk/
kolejowy	/kɔlɛˈjɔvɨ/
kłamca	[ˈkwam.t͡sa]
całkowicie	[t͡s̪awkɔˈvʲit͡ɕɛ]
całość	[ˈt͡sawɔɕt͡ɕ]
słoniowy	[swɔˈɲɔvɨ]
Ryby	[ˈrɨbɨ]
ryby	/ˈrɨbɨ/
Rak	[rak]
Bukareszt	/buˈkarɛʂt̪/
Ateny	[aˈtɛnɨ]
elektryczny	[ɛlɛkˈtrɨt͡ʂnɨ]
elektryczność	/ɛ.lɛkˈtrɨt͡ʂ.nɔɕt͡ɕ/
trzynaście	/t̪.ʂɨˈn̪aɕt͡ɕɛ/
czternaście	/t͡ʂt̪ɛɾˈn̪aɕt͡ɕɛ/
Strzelec	/ˈs̪t̪ʂɛlɛt͡s̪/
Waga	[ˈvaɡa]
Koziorożec	[kɔʑɔˈrɔʐɛt͡s]
koziorożec	[kɔʑɔˈrɔʐɛt͡s]
Madryt	[ˈmadrɨt]
Zagrzeb	/ˈz̪aɡʐɛp/
Wilno	[ˈvʲiln̪ɔ]
obok	/ˈɔbɔk/
siedzieć	[ˈɕed͡ʑet͡ɕ]
książę	[ˈkʲɕɔ̃w̃ʐɛ]
olsza	[ˈɔlʂa]
jodła	[ˈjɔdwa]
modrzew	[ˈmɔdʐef]
demonstrant	[dɛ̃ˈmɔ̃w̃strãnt]
skowronek	[skɔˈvrɔnɛk]
szesnaście	/ʂɛs̪ˈn̪aɕt͡ɕɛ/
co najmniej	[t͡sɔˈnajmɲɛj]
piosenka	[pʲɔˈsɛnka]
rudzik	[ˈrud͡ʑik]
płomykówka	/pwɔmɨˈkufka/
wilga	/ˈvilɡa/
paszkot	[ˈpaʂkɔt]
prośba	[ˈprɔʑba]
buty	/ˈbutɨ/
ręce	[ˈrɛ̃n̪t͡s̪ɛ]
chociaż	[ˈxɔt͡ɕaʂ]
szafran	[ˈʂafran]
księcia	/ˈkʲɕɛɲt͡ɕa/
księciem	/ˈkʲɕɛɲt͡ɕɛm/
książąt	/ˈkʲɕɔw̃ʐɔn̪t̪/
książętami	/kʲɕɔw̃ʐɛn̪ˈt̪ami/
książętach	/kʲɕɔw̃ˈʐɛn̪t̪ax/
książętom	/kʲɕɔw̃ˈʐɛn̪t̪ɔm/
strażnik	[ˈstraʐɲik]
puszysty	[puˈʂɨstɨ]
agresywny	[aɡrɛˈsɨvnɨ]
kryzys	[ˈkrɨzɨs]
palenie	[paˈlɛɲɛ]
odradzać	/ɔˈd̪rad͡z̪at͡ɕ/
przeciw	/ˈpʂɛt͡ɕif/
podziemny	[pɔdˈʑɛmnɨ]
psianka	[ˈpɕanka]
umowa	[uˈmɔva]
dokonać	[dɔˈkɔnat͡ɕ]
przyprawiać	[pʂɨˈpravʲat͡ɕ]
Filipiny	/filiˈpinɨ/
prawie	[ˈpravʲɛ]
drogowy	[drɔˈɡɔvɨ]
kszyk	[kʂɨk]
muzyka	[ˈmuzɨka]
muzyka	[ˈmuzɨka]
spokój	[ˈspɔkuj]
późno	/ˈpuʑnɔ/
ciepło	[ˈt͡ɕɛpwɔ]
sprzedać	[ˈspʂɛdat͡ɕ]
sprzedawać	[spʂɛˈdavat͡ɕ]
przedsiębiorstwo	[pʂɛtɕɛmˈbʲɔrstfɔ]
fałszywy	[fawˈʂɨvɨ]
Malediwy	/malɛˈdivɨ/
Brazylia	[braˈzɨlʲja]
Paragwaj	[paˈraɡvaj]
Walia	[ˈvalʲa]
Seszele	[sɛˈʂɛlɛ]
zwyciężać	/zvɨˈt͡ɕɛ̃ʐat͡ɕ/
Mikronezja	/mikrɔˈnɛzja/
szarość	[ˈʂarɔɕt͡ɕ]
jeszcze	[ˈjɛʂt͡ʂɛ]
kiełbasa	[kʲɛwˈbasa]
trójkąt	/ˈt̪rujkɔn̪t̪/
spadać	[ˈspadat͡ɕ]
fant	[fant]
przyszły	[ˈpʂɨʂwɨ]
szczur	[ʂʈ͡ʂur]
długopis	[dwuˈɡɔpʲis]
łokieć	[ˈwɔkʲɛt͡ɕ]
żyła	[ˈʐɨwa]
ślina	[ˈɕlina]
gardło	[ˈɡardwɔ]
biodro	[ˈbʲjɔd̪rɔ]
łza	[wza]
kosztować	/kɔʂˈtɔvat͡ɕ/
karmić	[ˈkarmʲit͡ɕ]
ukrywać	/uˈkrɨvatɕ/
dokąd	[ˈd̪ɔkɔ̃n̪t̪]
płacić	[ˈpwat͡ɕit͡ɕ]
zbiór	[zbʲjur]
około	[ɔˈkɔwɔ]
sławny	[ˈswavnɨ]
łzy	/wzɨ/
łez	[wɛs]
pięść	[pʲjɛ̝̃ĩ̯ɕt͡ɕ]
prawdziwy	[pravˈd͡ʑivɨ]
jesion	/ˈjɛɕɔn/
monarcha	[mɔˈnarxa]
naczynie	[naˈt͡ʂɨɲɛ]
zbierać	[ˈzbʲɛrat͡ɕ]
kołysanka	[kɔwɨˈsanka]
zmysł	/zmɨsw/
londyński	[ˈlɔ̃n̪d̪ɨ̃ĩ̯s̪ʲci]
połowa	[pɔˈwɔva]
wyłącznik	[vɨˈwɔ̃nt͡ʂɲik]
Kolonia	[kɔˈlɔɲa]
Nowy Jork	[nɔvɨˈjɔrk]
wachlarz	[ˈvaxlaʂ]
pianistka	[pʲaˈɲistka]
umrzeć	[ˈũmʐɛt͡ɕ]
czym	[t͡ʂɨ̃m]
czego	[ˈt͡ʂɛɡɔ]
czemu	[ˈt͡ʂɛ̃mu]
komuś	[ˈkɔ̃muɕ]
kimś	[cĩmʲɕ]
czymś	/t͡ʂɨmɕ/
czemuś	[ˈt͡ʂɛ̃muɕ]
niczego	[ɲiˈt͡ʂɛɡɔ]
niczemu	[ɲiˈt͡ʂɛ̃mu]
niczym	[ˈɲit͡ʂɨ̃m]
nikt	[ɲikt]
nikogo	[ɲiˈkɔɡɔ]
nikomu	[ɲiˈkɔ̃mu]
nikim	[ˈɲicĩm]
kręgosłup	[krɛ̃ˈɡɔswup]
zakazać	/zaˈkazat͡ɕ/
rodzice	[rɔˈd͡ʑit͡s̪ɛ]
pozwalać	[pɔˈzvalat͡ɕ]
prawnuczka	[praˈvnut͡ʂka]
suknia	[ˈsukɲa]
złość	[zwɔɕt͡ɕ]
kolonia	/kɔˈlɔɲja/
prababcia	[praˈbapt͡ɕa]
ślub	/ɕlup/
obejmować	/ɔbɛjˈmɔvat͡ɕ/
bierzmowanie	/bʲɛʐmɔˈvaɲɛ/
kolacja	[kɔˈlat͡sja]
morderca	[mɔrˈdɛrt͡sa]
Dawid	[ˈd̪avʲit̪]
potrzebny	[pɔtˈʂɛbnɨ]
latawiec	/laˈtavʲɛt͡s/
kieszeń	[ˈkʲjɛʂɛɲ]
ciecz	[t͡ɕɛt͡ʂ]
rzeczywistość	[ʐɛt͡ʂɨˈvʲis̪t̪ɔɕt͡ɕ]
kiedyś	[ˈcɛd̪ɨɕ]
Łukasz	[ˈwukaʂ]
Józef	[ˈjuz̪ɛf]
Jerzy	/ˈjɛʐɨ/
rodzic	[ˈrɔd͡ʑit͡s]
piekarnia	[pʲɛˈkarɲa]
kwiaciarnia	/kfʲaˈt͡ɕarɲa/
cukiernia	[t͡suˈkʲɛrɲa]
aldehyd	[alˈd̪ɛxɨt̪]
biada	/ˈbʲada/
woleć	[ˈvɔlɛt͡ɕ]
karykatura	/karɨkaˈtura/
ind	[int]
kuropatwa	/kurɔˈpatfa/
Wielkanoc	[vʲɛlˈkanɔt͡s]
wizytówka	/vizɨˈtufka/
wielka	[ˈvʲjɛlka]
wielkie	/ˈvʲɛlkʲɛ/
wielcy	/ˈvjɛlt͡sɨ/
zabójstwo	[zaˈbujstfɔ]
ludobójstwo	[ludɔˈbujstfɔ]
ładowarka	[wadɔˈvarka]
Agnieszka	[aˈɡɲɛʂka]
obojczyk	/ɔˈbɔjt͡ʂɨk/
homar	/ˈxɔmar/
Indonezja	/indɔˈnɛzja/
MacBook	/ˈmaɡbuk/
tura	/ˈtura/
gruba	/ˈɡruba/
harmonogram	[xarmɔˈnɔɡram]
koszulka	[kɔˈʂulka]
spodenki	[spɔˈdɛnkʲi]
sukienka	[suˈkʲɛnka]
spódnica	[spuˈdɲit͡sa]
spódniczka	[spuˈdɲit͡ʂka]
garnitur	/ɡarˈɲitur/
złe	[z̪wɛ]
źli	/ʑli/
kurtka	/ˈkurtka/
marynarka	[marɨˈnarka]
bandaż	[ˈbandaʂ]
rękawica	[rɛ̃ŋkaˈvʲit͡s̪a]
rękawiczka	[rɛŋkaˈvʲit͡ʂka]
skarpetka	[skarˈpɛtka]
bluza	[ˈbluz̪a]
sutanna	[suˈtanːa]
biustonosz	[bʲusˈtɔnɔʂ]
stanik	[ˈstaɲik]
szal	[ʂal]
szalik	[ˈʂalʲik]
piżama	[pʲiˈʐama]
pidżama	[pʲiˈd͡ʐama]
szczęście	[ˈʂt͡ʂɛ̃ĩ̯ɕt͡ɕɛ]
zabraniać	/zaˈbraɲat͡ɕ/
powód	/ˈpɔvut/
przyczyna	[pʂɨˈt͡ʂɨna]
ciśnienie	[t͡ɕiɕˈɲẽɲɛ]
pustynia	[puˈstɨɲa]
łucznik	[ˈwut͡ʂɲik]
łuczniczka	[wut͡ʂˈɲit͡ʂka]
całka	[ˈt͡sawka]
żeglarz	[ˈʐɛɡlaʂ]
cudowny	[t͡suˈdɔvnɨ]
stożek	[ˈstɔʐɛk]
szyszka	[ˈʂɨʂka]
czworokąt	/t͡ʂfɔˈrɔkɔn̪t̪/
internetowy	[intɛrnɛˈtɔvɨ]
efekt	/ˈɛfɛkt/
fotka	/ˈfɔtka/
słony	[ˈswɔnɨ]
brzydki	/ˈbʐɨtkʲi/
ładny	[ˈwad̪n̪ɨ]
jebać	[ˈjɛbat͡ɕ]
pierdolić	[pʲjɛrˈdɔlit͡ɕ]
nieśmiałość	[ɲɛˈɕmʲawɔɕt͡ɕ]
analogowy	[analɔˈɡɔvɨ]
cyfrowy	[t͡sɨˈfrɔvɨ]
nieśmiertelny	[ɲɛɕmʲɛrˈtɛlnɨ]
nieśmiertelność	[ɲɛɕmʲɛrˈtɛlnɔɕt͡ɕ]
nieumarły	[ɲɛuˈmarwɨ]
elektronowy	[ɛlɛktrɔˈnɔvɨ]
elektroniczny	[ɛlɛktrɔˈɲit͡ʂnɨ]
smutny	[ˈsmutnɨ]
techniczny	[tɛxˈɲit͡ʂnɨ]
sadza	[ˈsad͡za]
radiowy	/raˈdjɔvɨ/
aromat	[aˈrɔmat]
upokorzenie	[upɔkɔˈʐɛɲɛ]
lekarz	[ˈlɛkaʂ]
lekarka	[lɛˈkarka]
wcześnie	[ˈft͡ʂɛɕɲɛ]
wczesny	[ˈft͡ʂɛs̪n̪ɨ]
mundur	[ˈmundur]
mundurek	[munˈdurɛk]
dres	[drɛs]
fartuch	[ˈfartux]
kombinezon	/kɔmbiˈnɛzɔn/
szata	[ˈʂata]
szarawary	[ʂaraˈvarɨ]
nie rozumiem	/ɲɛ rɔˈz̪umjɛm/
magnetofon	/maɡn̪ɛˈt̪ɔfɔn̪/
przyjmować	/pʂɨjˈmɔvat͡ɕ/
kawaler	[kaˈvalɛr]
szlug	[ʂluk]
zdrobnienie	[zdrɔbˈɳɛ.ɳɛ]
dysza	/ˈdɨʂa/
wpływ	/fpwɨf/
pępek	[ˈpɛ̃mpɛk]
świątynia	[ɕfʲjɔ̃n̪ˈt̪ɨ̃ɲa]
skrzypaczka	[skʂɨˈpat͡ʂka]
kaganiec	[kaˈɡaɲɛt͡s]
biurko	[ˈbʲurkɔ]
biurowy	[bʲjuˈrɔvɨ]
cesarstwo	[t͡sɛˈsarstfo]
bezpieczny	[bɛs̪ˈpʲjɛt͡ʂn̪ɨ]
niebezpieczny	/ˌɲɛbɛsˈpʲɛt͡ʂnɨ/
małż	[mawʂ]
orzechowy	/ɔʐɛˈxɔvɨ/
deklinacja	[dɛklʲiˈnat͡sja]
koniugacja	[kɔɲuˈɡat͡sja]
pacjent	[ˈpat͡sjɛnt]
pacjentka	[paˈt͡sjɛntka]
siedemnaście	/ɕɛd̪ɛmˈn̪aɕt͡ɕɛ/
osiemnaście	/ɔɕɛmˈn̪aɕt͡ɕɛ/
dziewiętnaście	/d͡ʑɛvʲɛt̪ˈn̪aɕt͡ɕɛ/
dwadzieścia	/d̪vaˈd͡ʑɛɕt͡ɕa/
makolągwa	/makɔˈlɔŋɡva/
wodniczka	[vɔˈdɲit͡ʂka]
cierniówka	/t͡ɕɛrˈɲufka/
jarzębatka	/jaʐɛmˈbatka/
perkoz	[ˈpɛrkɔs]
szablodziób	[ʂaˈblɔd͡ʑup]
świstun	[ˈɕfʲistun]
szlachar	/ˈʂlaxar/
rabunek	[raˈbunɛk]
otaczać	[ɔˈtat͡ʂat͡ɕ]
cień	[t͡ɕẽɲ]
jednorożec	[jɛdnɔˈrɔʐɛt͡s]
turystka	/tuˈrɨstka/
tzn.	[tɔˈznat͡ʂɨ]
akwarium	/aˈkfarjum/
gimnazjum	[ɡimˈnazjum]
zadzwonić	/zaˈd͡zvɔɲit͡ɕ/
zmienić	[ˈz̪mʲjeɲit͡ɕ]
sferze	[ˈsfɛʐɛ]
wasz	/vaʂ/
swój	[sfuj]
gdzie Rzym, gdzie Krym	/ɡd͡ʑɛ ˈʐɨm ɡd͡ʑɛ ˈkrɨm/
bądź	[bɔ̃ɲt͡ɕ]
drożdżówka	[d̪rɔʐˈd​͡ʐ̠ufka]
zobaczyć	[zɔˈbat͡ʂɨt͡ɕ]
do zobaczenia	/d̪ɔ z̪ɔbaˈt͡ʂɛɲa/
miłe	/ˈmiwɛ/
tysiąc	[ˈt̪ɨɕɔ̃n̪t͡s̪]
milion	[ˈmʲilʲjɔ̃n̪]
pomyśleć	/pɔˈmɨɕlɛt͡ɕ/
pytać	/ˈpɨtat͡ɕ/
sukces	/ˈsukt͡sɛs/
teatr	[ˈt̪ɛat̪r̥]
sarkofagi	[s̪arkɔˈfaɟi]
dobrobyt	/dɔˈbrɔbɨt/
białko	[ˈbʲjawkɔ]
umysł	[ˈũmɨsw̥]
pomysł	[ˈpɔ̃mɨsw̥]
przemysł	[ˈpʂɛ̃mɨsw̥]
przemysłowy	[pʂɛ̃mɨˈswɔvɨ]
posłuchać	/pɔˈswuxat͡ɕ/
chodnik	/ˈxɔdɲik/
pasztet	/ˈpaʂtɛt/
zwycięzca	/zvɨˈt͡ɕɛ̃w̃st͡sa/
garaż	/ˈɡaraʂ/
masz	[maʂ]
Wiśniewski	[vʲiˈɕɲɛfskʲi]
Wójcik	/ˈvujt͡ɕik/
Dąbrowski	[dɔ̃mˈbrɔfskʲi]
Wojciechowski	[vɔjt͡ɕɛˈxɔfskʲi]
chodź	[xɔt͡ɕ]
budzić	/ˈbud͡ʑit͡ɕ/
pamiętać	/paˈmjɛntat͡ɕ/
skarb	/ˈskarp/
porażka	/pɔˈraʂka/
świetny	[ˈɕfʲjɛtnɨ]
zabić	/ˈzabit͡ɕ/
rozsadzać	/rɔsˈsad͡zat͡ɕ/
klasa	/ˈklasa/
domu	[ˈd̪ɔ̃mu]
cielęcina	[t͡ɕɛlɛ̃ɲˈt͡ɕĩn̪a]
wieprzowina	[vʲjɛp.ʂɔˈvʲĩ.na]
wieprz	[ˈvʲjɛpʂ]
Kozłowski	[kɔˈzwɔfskʲi]
śruba	[ˈɕruba]
dwusetny	/d̪vuˈs̪ɛt̪n̪ɨ/
dwóchsetny	/d̪vuxˈs̪ɛt̪n̪ɨ/
trzechsetny	/t.ʂɛxˈsɛtnɨ/
czterechsetny	/t͡ʂtɛrɛxˈsɛtnɨ/
pięćsetny	/pjɛɲt͡ɕˈsɛtnɨ/
sześćsetny	/ʂɛɕˈsɛtnɨ/
siedemsetny	/ɕɛdɛmˈsɛtnɨ/
osiemsetny	/ɔɕɛmˈsɛtnɨ/
dziewięćsetny	/d͡ʑɛvjɛɲt͡ɕˈsɛtnɨ/
tysiączny	/tɨˈɕɔnt͡ʂnɨ/
przychodzić	[pʂɨˈxɔd͡ʑit͡ɕ]
poprosić	/pɔˈprɔɕit͡ɕ/
przeprosić	/pʂɛˈprɔɕit͡ɕ/
zaufać	/z̪aˈufat͡ɕ/
celnik	[ˈt͡sɛlɲik]
pożyczać	/pɔˈʐɨt͡ʂat͡ɕ/
pożyczyć	/pɔˈʐɨt͡ʂɨt͡ɕ/
gil	[ɟil]
faszyzm	/ˈfaʂɨzm/
dość	[dɔɕt͡ɕ]
klamka	/ˈklamka/
niewygodny	/ɲɛvɨˈɡɔdnɨ/
wygodny	/vɨˈɡɔdnɨ/
ciągnąć	/ˈt͡ɕɔŋɡnɔɲt͡ɕ/
entuzjazm	/ɛnˈtuzjazm/
bukiet	/ˈbukʲɛt/
naprzeciw	/naˈpʂɛt͡ɕif/
szczegół	[ˈʂt͡ʂɛɡuw]
klasztor	[ˈklaʂtɔr]
zabawka	[zaˈbafka]
ssać	/sːatɕ/
okradać	/ɔˈkradat͡ɕ/
nerka	/ˈnɛrka/
laska	/ˈlaska/
rzeźba	/ˈʐɛʑba/
rzeźbiarstwo	/ˈʐɛʑbjarstfɔ/
rzeźnik	/ˈʐɛʑɲik/
górnik	/ˈɡurɲik/
ambulans	[ãmˈbulã(w̃)s̪]
karetka	/kaˈrɛtka/
mnie	[mʲɲɛ]
wejście	[ˈvɛjɕt͡ɕɛ]
Algieria	/alˈɡʲɛrja/
Azerbejdżan	/azɛrˈbɛjd͡ʐan/
odpowiedzieć	[ɔtpɔvʲɛd͡ʐɛt͡ɕ]
równość	/ˈruvnɔɕt͡ɕ/
konkurs	/ˈkɔŋkurs/
brzmieć	/ˈbʐmjɛt͡ɕ/
wszędzie	[ˈfʂɛ̃ɲd͡ʑɛ]
gdzieś	/ɡd͡ʑɛɕ/
niewolnik	/ɲɛˈvɔlɲik/
podpalenie	/pɔdpaˈlɛɲɛ/
bawełna	/baˈvɛwna/
granat	/ˈɡran̪at̪/
pleśń	/plɛɕɲ/
krzyż	/kʂɨʂ/
świnka morska	[ˈɕfʲinka ˈmɔɾska]
fosa	/ˈfɔsa/
powyłamywany	/pɔvɨwamɨˈvanɨ/
syf	/sɨf/
syfek	/ˈsɨfɛk/
walet	/ˈvalɛt/
karty	/ˈkartɨ/
dżoker	/ˈd͡ʐɔkɛr/
karo	/ˈkarɔ/
trefl	[trɛfl̥]
dwójka	/ˈdvujka/
kareta	/kaˈrɛta/
trójka	/ˈtrujka/
zerowy	/zɛˈrɔvɨ/
dwutysięczny	/dvutɨˈɕɛnt͡ʂnɨ/
Birma	/ˈbirma/
Boliwia	/bɔˈlivja/
Cypr	[t͡sɨpr̥]
Czarnogóra	/t͡ʂarnɔˈɡura/
Dominikana	/dɔmiɲiˈkana/
Ekwador	/ɛˈkfadɔr/
tajny	/ˈtajnɨ/
Fidżi	[ˈfʲid͡ʒi]
Gruzja	/ˈɡruzja/
Gwatemala	/ɡvatɛˈmala/
Gwinea	/ɡviˈnɛa/
Kambodża	/kamˈbɔd͡ʐa/
zostawać	[zɔˈstavat͡ɕ]
Korea Południowa	/kɔˌrɛa‿pɔwuˈdɲɔva/
Korea Północna	/kɔˌrɛa‿puwˈnɔt͡sna/
Czechosłowacja	/ˌt͡ʂɛxɔswɔˈvat͡sja/
poezja	/pɔˈɛzja/
kałuża	/kaˈwuʐa/
wojenny	/vɔˈjɛnːɨ/
przedwojenny	/pʂɛtvɔˈjɛnːɨ/
powojenny	/pɔvɔˈjɛnːɨ/
powietrzny	/pɔˈvjɛt.ʂnɨ/
Papua-Nowa Gwinea	/paˈpu.a ˈnɔ.va ɡviˈnɛ.a/
lankijski	[lãŋʲˈkʲijs̪ʲkʲi]
Suazi	/suˈazi/
szaleństwo	[ʂaˈlɛ̃ĩ̯s̪t̪fɔ]
Tadżykistan	/t̪ad͡ʐɨˈkʲis̪t̪an̪/
Tunezja	/t̪uˈn̪ɛz̪ja/
Turcja	/ˈt̪urt͡s̪ja/
tuwalski	/t̪uˈvals̪kʲi/
Czeczenia	/t͡ʂɛˈt͡ʂɛɲja/
Urugwaj	/uˈruɡvaj/
Watykan	/vaˈt̪ɨkan̪/
Persja	/ˈpɛrs̪ja/
opór	/ˈɔpur/
nie mówię po polsku	/ɲɛ ˈmuvjɛ pɔ ˈpɔls̪ku/
nie ma za co	/ɲɛ ma z̪a t͡s̪ɔ/
czytelny	/t͡ʂɨˈtɛlnɨ/
rachunek	/raˈxun̪ɛk/
żydowski	/ʐɨˈd̪ɔfs̪kʲi/
danie	/ˈd̪aɲɛ/
prace	/ˈprat͡s̪ɛ/
kadet	/ˈkadɛt/
kasyno	/kaˈs̪ɨn̪ɔ/
staw	/s̪t̪af/
figi	[ˈfʲiɡʲi]
pracy	/ˈprat͡s̪ɨ/
pracę	/ˈprat͡s̪ɛ/
pracą	/ˈprat͡s̪ɔw̃/
praco	/ˈprat͡s̪ɔ/
prac	/ˈprat͡s̪/
pracom	/ˈprat͡s̪ɔm/
pracami	/praˈt͡s̪ami/
pracach	/ˈprat͡s̪ax/
pracowity	/prat͡s̪ɔˈvitɨ/
nosowy	[n̪ɔˈs̪ɔvɨ]
Katowice	[kat̪ɔˈvʲit͡s̪ɛ]
Gdynia	/ˈɡd̪ɨɲa/
Radom	/ˈrad̪ɔm/
Sosnowiec	/s̪ɔs̪ˈn̪ɔvjɛt͡s̪/
Toruń	/ˈt̪ɔruɲ/
Kielce	[kʲɛlt͡s̪ɛ]
Gliwice	[ɡlʲiˈvʲit͡s̪ɛ]
Zabrze	/ˈz̪abʐɛ/
Bytom	/ˈbɨt̪ɔm/
Olsztyn	/ˈɔlʂt̪ɨn̪/
Bielsko-Biała	/ˌbjɛls̪kɔ‿ˈbjawa/
Rzeszów	/ˈʐɛʂuf/
sędzia	/ˈs̪ɛɲd͡ʑa/
prokurator	/prɔkuˈrat̪ɔr/
czaszka	/ˈt͡ʂaʂka/
żarówka	/ʐaˈrufka/
pech	[pɛx]
uczeń	/ˈut͡ʂɛɲ/
czyścić	/t͡ʂɨɕt͡ɕit͡ɕ/
muzyk	/ˈmuz̪ɨk/
tarcza	/ˈt̪art͡ʂa/
czujesz	[ˈt͡ʂujɛʂ]
Zgierz	[zɡjɛʂ]
Ruda Śląska	/ˌrud̪a ˈɕlɔw̃s̪ka/
Rybnik	/ˈrɨbɲik/
Tychy	/ˈt̪ɨxɨ/
Dąbrowa Górnicza	/d̪ɔmˌbrɔva ɡurˈɲit͡ʂa/
Płock	/pwɔt͡s̪k/
Opole	/ɔˈpɔlɛ/
Elbląg	[ˈɛlblɔ̃ŋk]
Wałbrzych	/ˈvawbʐɨx/
Włocławek	/vwɔt͡s̪ˈwavɛk/
Zielona Góra	/ʑɛˌlɔn̪a ˈɡura/
zmrok	/zmrɔk/
Mirosław	/miˈrɔswaf/
Grzegorz	/ˈɡʐɛɡɔʂ/
wilkołak	/vilˈkɔwak/
pełnia	/ˈpɛwɲa/
nów	/nuf/
weekendowy	/wikɛn̪ˈd̪ɔvɨ/
szablon	/ˈʂablɔn̪/
blacha	/ˈblaxa/
cecha	/ˈt̪͡s̪ɛxa/
marycha	/maˈrɨxa/
olcha	[ˈɔlxa]
pielucha	/pjɛˈluxa/
krucjata	/kruˈt͡s̪jat̪a/
szprycha	/ˈʂprɨxa/
wajcha	/ˈvajxa/
dźwignia	/ˈd͡ʑviɡɲa/
haszysz	/ˈxaʂɨʂ/
matula	/maˈtula/
nirwana	/ɲirˈvana/
Xbox	/ˈiɡzbɔks/
Xbox	/ˈiɡzbɔks/
Xbox	/iɡzˈbɔksɨ/
Xbox	/iɡzˈbɔksa/
Xbox	/iɡzˈbɔksuf/
Xbox	/iɡzbɔˈksɔvi/
Xbox	/iɡzˈbɔksɔm/
Xbox	/ˈiɡzbɔks/
Xbox	/iɡzˈbɔksɨ/
Xbox	/iɡzˈbɔksɛm/
Xbox	/iɡzbɔˈksami/
Xbox	/iɡzˈbɔkɕɛ/
Xbox	/iɡzˈbɔksax/
Xbox	/iɡzˈbɔkɕɛ/
Xbox	/iɡzˈbɔksɨ/
kosmiczny	/kɔs̪ˈmit͡ʂn̪ɨ/
zdrowie	/ˈz̪d̪rɔvjɛ/
Tarnów	/ˈt̪arn̪uf/
Chorzów	/ˈxɔʐuf/
Kalisz	/ˈkaliʂ/
Koszalin	/kɔˈʂalin̪/
Legnica	/lɛˈɡʲɲit͡s̪a/
Grudziądz	/ˈɡrud͡ʑɔn̪t͡s̪/
Słupsk	/s̪wups̪k/
Jaworzno	/jaˈvɔʐn̪ɔ/
Jastrzębie-Zdrój	[jaˌs̪t.ʂɛ̃mbʲjɛ ˈz̪d̪ruj]
Jelenia Góra	/jɛˌlɛɲa ˈɡura/
były	/ˈbɨwɨ/
porzeczka	/pɔʐɛt͡ʂka/
morwa	/ˈmɔrva/
silnik	/ˈɕilɲik/
paproć	/ˈpaprɔt͡ɕ/
bluszcz	/bluʂt͡ʂ/
młynarz	/ˈmwɨnaʂ/
cierpliwość	/t͡ɕɛrˈplivɔɕt͡ɕ/
Abchazja	/apˈxaz̪ja/
hormon	/ˈxɔrmɔn̪/
Palestyna	/palɛˈs̪t̪ɨn̪a/
znów	/znuf/
mól	/mul/
dialektologia	/ˈd̪jalɛkt̪ɔˈlɔɡʲa/
opinia	[ˈɔpʲiɲja]
niego	[ˈɲɛɡɔ]
przedszkole	/pʂɛtˈʂkɔlɛ/
zbrodnia	/ˈz̪brɔd̪ɲa/
winny	/ˈvin̪n̪ɨ/
winny	[ˈvʲĩn̪n̪ɘ̟]
niewinny	/ɲɛˈvin̪n̪ɨ/
niewinny	[ɲɛˈvʲĩn̪n̪ɘ̟]
podejrzany	/pɔd̪ɛjˈʐan̪ɨ/
gdziekolwiek	[ɟd͡ʑɛˈkɔlvʲjɛk]
przenośny	/pʂɛˈn̪ɔɕn̪ɨ/
inwestycja	/iw̃vɛˈs̪t̪ɨt͡s̪ja/
dostęp	/ˈd̪ɔs̪t̪ɛmp/
niemowlę	/ɲɛˈmɔvlɛ/
wydra	/ˈvɨd̪ra/
nadal	/ˈnadal/
siódemka	/ɕuˈd̪ɛmka/
kryształ	/ˈkrɨʂ.t̪aw/
klikać	[ˈklʲikat͡ɕ]
wersja	/ˈvɛrs̪ja/
szczekać	[ˈʂt͡ʂɛkat͡ɕ]
semestr	[ˈs̪ɛ̃mɛs̪t̪r̥]
Troja	/ˈtrɔja/
kangur	[ˈkãŋɡur]
zajączek	[ˈz̪ajɔnt͡ʂɛk]
buddyzm	/ˈbud̪ːɨz̪m/
pajączek	[paˈjɔ̃nt͡ʂɛk]
Wołga	/ˈvɔwɡa/
bursztyn	/ˈburʂtɨn/
gatunek	/ɡaˈt̪un̪ɛk/
łuska	/ˈwus̪ka/
bić	[bʲit͡ɕ]
sprzedaż	/ˈs̪pʂɛd̪aʂ/
pokład	/ˈpɔkwat/
uprzejmy	/uˈpʂɛjmɨ/
namawiać	/n̪aˈmavjat͡ɕ/
nałóg	/ˈnawuk/
fryzjer	/ˈfrɨzʲjɛr/
szyfr	[ʂɨfr̥]
nerw	/nɛrf/
czarna dziura	[ˈt͡ʂar.na ˈd͡ʑu.ra]
plecak	/ˈplɛt͡sak/
dojrzały	/dɔjˈʐawɨ/
ryczałt	/ˈrɨt͡ʂawt/
Drezno	/ˈdrɛznɔ/
superkomputer	/supɛrkɔmˈput̪ɛr/
tkanka	/ˈt̪kan̪ka/
szczęka	[ˈʂt͡ʂɛ̃ŋka]
żuchwa	/ˈʐuxfa/
szkielet	/ˈʂkʲɛlɛt̪/
skroń	/ˈskrɔɲ/
krzew	/kʂɛf/
dożywotni	/dɔʐɨˈvɔtɲi/
skąpiec	/ˈs̪kɔmpʲjɛt͡s̪/
hańba	[ˈxaɲba]
dziobak	/ˈd͡ʑɔbak/
soból	/ˈsɔbul/
żółtko	/ˈʐuwtkɔ/
awokado	/avɔˈkad̪ɔ/
nektaryna	/n̪ɛkt̪aˈrɨn̪a/
klarnet	/ˈklarnɛt/
lutnia	/ˈlutɲa/
altówka	/alˈtufka/
gwałt	/ɡvawt̪/
pszczelarz	/ˈpʂt͡ʂɛlaʂ/
bednarz	/ˈbɛdnaʂ/
napięcie	/n̪aˈpjɛɲt͡ɕɛ/
keczup	/ˈkɛt͡ʂup/
przyjaźń	[ˈpʂɨjaɕɲ̊]
anyż	/ˈan̪ɨʂ/
perła	/ˈpɛrwa/
mozaika	/mɔˈz̪ajka/
stolarz	/ˈstɔlaʂ/
rybak	/ˈrɨbak/
murarz	/ˈmuraʂ/
dachówka	/daˈxufka/
dach	/dax/
dekarz	/ˈdɛkaʂ/
tatuaż	/taˈtuaʂ/
niemy	/ˈɲɛmɨ/
dereń	/ˈdɛrɛɲ/
lulek	/ˈlulɛk/
Łaba	/ˈwaba/
jakoś	/ˈjakɔɕ/
Berno	/ˈbɛrnɔ/
taras	/ˈtaras/
akwedukt	/aˈkfɛd̪ukt̪/
demokracja	/d̪ɛmɔˈkrat͡s̪ja/
pęd	/pɛn̪t̪/
standardowy	/s̪t̪an̪d̪arˈd̪ɔvɨ/
standardu	/s̪t̪an̪ˈd̪ard̪u/
standardzie	/s̪t̪an̪ˈd̪ard͡ʑɛ/
Andrzej	[ˈãn̪d.ʐɛj]
Andrzej	[ˈãnd͡ʐ.ʐɛj]
Małgorzata	/mawɡɔˈʐat̪a/
Elżbieta	/ɛlˈʐbjɛt̪a/
Zofia	/ˈz̪ɔfja/
płot	/pwɔt̪/
gwóźdź	/ɡvuɕt͡ɕ/
prosta	/ˈprɔs̪t̪a/
półprosta	/puwˈprɔs̪t̪a/
odcinek	/ɔt̪ˈt͡ɕin̪ɛk/
krzywa	/ˈkʂɨva/
przekątna	/pʂɛˈkɔn̪t̪n̪a/
styczna	/ˈs̪t̪ɨt͡ʂn̪a/
szyć	/ʂɨt͡ɕ/
koszmar	/ˈkɔʂmar/
prędkość	/ˈprɛn̪t̪kɔɕt͡ɕ/
niania	/ˈɲaɲa/
dysproz	/ˈdɨsprɔs/
terb	/tɛrp/
samar	/ˈsamar/
ziewać	/ˈʑɛvat͡ɕ/
podobny	[pɔˈd̪ɔbn̪ɨ]
katamaran	[kataˈmaɾan]
platyna	/plaˈtɨna/
iryd	/ˈirɨt/
mylić	/ˈmɨlit͡ɕ/
prawny	[ˈpravn̪ɨ]
aktyn	/ˈaktɨn/
frans	/frans/
polon	/ˈpɔlɔn/
romb	/ˈrɔmp/
obwód	/ˈɔbwut̪/
średnica	/ɕrɛdˈɲit͡s̪a/
filolog	/fiˈlɔlɔk/
bryła	/ˈbrɨwa/
Moza	/ˈmɔza/
Warta	/ˈvarta/
cyrkon	/ˈt͡sɨrkɔn/
technet	/ˈtɛxnɛt/
berkel	/ˈbɛrkɛl/
cierpliwy	[t͡ɕɛrˈplʲivɨ]
iterb	/ˈitɛrp/
tul	/tul/
zębowy	/z̪ɛmˈbɔvɨ/
dziąsło	[ˈd͡ʑɔ̃w̃s̪wɔ]
dźwięczny	[ˈd͡ʑvʲjɛ̃nt͡ʂn̪ɨ]
bezdźwięczny	[bɛz̪ˈd͡ʑvʲjɛ̃nt͡ʂn̪ɨ]
ekspert	/ˈɛkspɛrt/
malarz	/ˈmalaʂ/
Rodan	/ˈrɔdan/
Tyber	/ˈtɨbɛr/
Sztokholm	/ˈʂtɔkxɔlm/
Azory	/aˈzɔrɨ/
wydma	/ˈvɨdma/
południk	/pɔˈwudɲik/
ślaz	/ɕlas/
dudek	/ˈdudɛk/
szympans	/ˈʂɨmpans/
grzywa	[ˈɡʐɨ.va]
ptaszek	/ˈpt̪aʂɛk/
miętowy	/mjɛn̪ˈt̪ɔvɨ/
perliczka	/pɛrˈlit͡ʂka/
uczta	/ˈut͡ʂt̪a/
fuj	/fuj/
fuj	/fuːj/
Grenlandia	/ɡrɛn̪ˈlan̪d̪ja/
Korsyka	/ˈkɔrs̪ɨka/
Sycylia	/s̪ɨt͡s̪ɨlja/
papierowy	/papjɛˈrɔvɨ/
bukszpan	/ˈbukʂpan̪/
ż	/ʐ/
Ż	/ʐ/
główny	[ˈɡwuvn̪ɨ]
dokładnie	/d̪ɔˈkwad̪ɲɛ/
mamusia	/maˈmuɕa/
tatuś	/ˈt̪at̪uɕ/
sabotaż	/s̪aˈbɔt̪aʂ/
kameleon	[kãmɛˈlɛɔ̃n̪]
dosłownie	/d̪ɔˈs̪wɔvɲɛ/
czujność	/ˈt͡ʂujn̪ɔɕt͡ɕ/
mżawka	/ˈmʐafka/
kompozytor	/kɔm.pɔˈzɨ.tɔr/
szewc	/ʂɛft͡s/
Haga	/ˈxaɡa/
Kapsztad	/ˈkapʂtat/
posag	/ˈpɔs̪ak/
infrastruktura	[in.fra.strukˈtu.ra]
entuzjasta	/ɛntuzˈjasta/
stopniowo	/s̪t̪ɔˈpɲɔvɔ/
zatoka	/zaˈtɔka/
pomnik	/ˈpɔmɲik/
długo	/ˈdwuɡɔ/
krótko	/ˈkrut̪kɔ/
krótkofalówka	/krutkɔfaˈlufka/
długowłosy	/ˌdwuɡɔˈvwɔsɨ/
rozsądnie	/rɔˈs̪ːɔn̪d̪ɲɛ/
uzależniony	/uz̪alɛˈʐɲɔn̪ɨ/
miligram	/miˈliɡram/
decymetr	[d̪ɛˈt͡s̪ɨmɛt̪r̥]
milimetr	[mʲiˈlʲĩmɛt̪r̥]
fretka	[ˈfrɛtka]
zatrudniać	/zaˈtrudɲat͡ɕ/
pracuje	[praˈt͡s̪ujɛ]
nimfa	[ˈɲim.fa]
siarczan	/ˈɕart͡ʂan/
administracja	[ad̪mʲĩɲiˈs̪t̪rat͡s̪ʲja]
do kurwy nędzy	/dɔ ˈkur.vɨ ˈnɛn.d͡zɨ/
szczawik	[ˈʂt͡ʂavʲik]
abdykacja	/ab.dɨˈka.t͡sja/
rolnik	/ˈrɔlɲik/
pobożny	/pɔˈbɔʐnɨ/
daleko	[d̪aˈlɛkɔ]
kalumnia	/kaˈlumɲa/
jabłkowy	[japw̥ˈkɔvɨ]
Lublana	/luˈblan̪a/
zakładnik	/zaˈkwadɲik/
płacz	[pwat͡ʂ]
wektor	/ˈvɛktɔr/
szerszeń	/ˈʂɛrʂɛɲ/
wyka	/ˈvɨka/
kwazar	/ˈkfaz̪ar/
Jakuck	/ˈjakut͡sk/
Irkuck	/ˈirkut͡sk/
Tajwan	/ˈt̪ajvan̪/
prezydent	/ˈprɛz̪ɨd̪ɛn̪t̪/
zupełnie	/zuˈpɛwɲɛ/
wstyd	/fs̪t̪ɨt̪/
krewny	[ˈkrɛvn̪ɨ]
krewna	[ˈkrɛvn̪a]
krewni	[ˈkrɛvʲɲi]
chrapać	/ˈxrapat͡ɕ/
marzyć	/ˈmaʐɨt͡ɕ/
oraz	/ˈɔras/
kaszel	/ˈkaʂɛl/
zwyczajny	/z̪vɨˈt͡ʂajn̪ɨ/
manometr	/maˈnɔmɛtr/
Sewilla	/sɛˈvilːa/
Sewilla	/sɛˈvija/
wątpliwość	[vɔ̃n̪t̪ˈplʲivɔɕt͡ɕ]
tchórz	/t̪xuʂ/
dekret	/ˈdɛkrɛt/
edykt	/ˈɛdɨkt/
Wandal	/ˈvandal/
narząd	/ˈn̪aʐɔn̪t̪/
łapówka	/waˈpufka/
bluszczyk	/ˈbluʂt͡ʂɨk/
Donieck	[ˈd̪ɔ̃ɲɛt͡s̪k]
gromadzić	/ɡrɔˈmad͡ʑit͡ɕ/
bosa	/ˈbɔsa/
uniwersytet	/uɲiˈvɛrs̪ɨt̪ɛt̪/
mała	[ˈmawa]
psy	/psɨ/
skakać	/ˈs̪kakat͡ɕ/
rzygać	/ˈʐɨɡat͡ɕ/
fiołek	[ˈfʲjɔwɛk]
łąka	[ˈwɔ̃ŋka]
chyba że	/xɨba ˈʐɛ/
dziób	/d͡ʑup/
rynek	/ˈrɨn̪ɛk/
kotwica	[kɔˈt̪fʲit͡s̪a]
objętość	/ɔˈbjɛn̪t̪ɔɕt͡ɕ/
austriacki	/aws̪t̪rɨˈjat͡s̪kʲi/
hałas	/ˈxawas̪/
domy	/ˈd̪ɔmɨ/
domek	/ˈd̪ɔmɛk/
domowy	/dɔˈmɔvɨ/
alkohole	/alkɔˈxɔlɛ/
ablatyw	[aˈblat̪ɨf]
bałwan	/ˈbawvan̪/
przeciąg	[ˈpʂɛt͡ɕɔ̃ŋk]
morderstwo	/mɔrˈdɛr.stfɔ/
spotkanie	[s̪pɔˈt̪kãɲɛ]
Facebook	/ˈfɛjzbuk/
tworzyć	/ˈtfɔʐɨt͡ɕ/
jesiotr	[ˈjɛɕɔt̪r̥]
rosół	/ˈrɔs̪uw/
Zurych	/ˈt͡s̪urɨx/
rządzić	/ˈʐɔɲd͡ʑit͡ɕ/
lisi	[lʲiɕi]
ssaki	/sːa.ki/
gniazdo	[ˈɡʲɲaz̪d̪ɔ]
winorośl	[vʲĩˈn̪ɔrɔɕl̥]
ludność	[ˈlud̪n̪ɔɕt͡ɕ]
potrzeba	[pɔˈtʂɛ.ba]
wysiłek	/vɨˈɕiwɛk/
pszeniec	/ˈpʂɛɲɛt͡s/
wesprzeć	/ˈvɛspʂɛt͡ɕ/
weranda	/veˈranda/
smaczny	/ˈsmat͡ʂnɨ/
gniady	/ˈɡʲɲad̪ɨ/
mocny	/ˈmɔt͡s̪n̪ɨ/
płciowy	[pwuˈt͡ɕɔvɨ]
ułamek	/ˈuwamɛk/
ciąć	/ˈt͡ɕɔɲt͡ɕ/
tnę	[ˈtnɛ̃]
tniesz	[ˈtɲɛʂ]
śnieżka	/ˈɕɲɛʂka/
kolęda	/kɔˈlɛn̪d̪a/
Mikołaj	[mʲiˈkɔwaj]
trochę	/ˈt̪rɔxɛ/
maciejka	[maˈt͡ɕejka]
kalarepa	/kalaˈrɛpa/
kosarz	/ˈkɔsaʂ/
dubstep	/ˈdapstɛp/
cisza	/ˈt͡ɕiʂa/
cietrzew	[ˈt͡ɕɛt.ʂɛf]
cennik	/ˈt͡s̪ɛɲːik/
potęga	[pɔˈt̪ɛ̃ŋɡa]
naprawdę	[n̪aˈpravd̪ɛ]
cynamon	/t̪͡s̪ɘˈnämɔn/
Zelandia	/zɛˈlandja/
jesienny	/jɛˈɕɛn̪ːɨ/
silnia	/ˈɕilɲa/
Łużyce	/wuˈʐɨt͡sɛ/
kiszka	/ˈkʲiʂka/
niuton	/ˈɲut̪ɔn̪/
stajnia	/ˈs̪t̪ajɲa/
ręcznik	[ˈrɛ̃nt͡ʂɲik]
bułka	/ˈbuwka/
mocno	[ˈmɔt͡s̪n̪ɔ]
koszt	/kɔʂt̪/
kadłub	/ˈkadwup/
policzek	/pɔˈlit͡ʂɛk/
krtań	[ˈkr̥t̪ãɲ]
kołdra	/ˈkɔwd̪ra/
przyprawa	/pʂɨˈprava/
mąka	[ˈmɔ̃ŋka]
buraku	/buˈraku/
wiem	[vʲjɛ̃m]
wiesz	[vʲjɛʂ]
nie wiem	/ˈɲɛ vjɛm/
która godzina	/ˌkt̪ura ɡɔˈd͡ʑin̪a/
gliniarz	[ˈɡʎiɲaʂ]
linia	[ˈlʲĩɲja]
ziarno	/ˈʑarn̪ɔ/
kraina	/kraˈin̪a/
bobas	/bɔbas/
pewien	[ˈpɛvʲjɛ̃n̪]
filozofia	/filɔˈz̪ɔfja/
tłusty	/ˈt̪wus̪t̪ɨ/
pedagog	/pɛˈdaɡɔk/
szybko	/ˈʂɨpkɔ/
rafa	/ˈrafa/
kurnik	/ˈkurɲik/
inna	[ˈĩn̪ːa]
wylać	/ˈvɨlat͡ɕ/
zioło	/ˈʑɔwɔ/
kościelny	/kɔɕˈt​͡ɕɛlnɨ/
pączek	[ˈpɔ̃nt͡ʂɛk]
chrzan	/ˈxʂan̪/
ciasteczko	[t͡ɕaˈs̪t̪ɛt͡ʂkɔ]
herby	[ˈxɛrbɨ]
dubeltówka	/d̪ubɛlˈt̪ufka/
główka	/ˈɡwufka/
parówka	/paˈrufka/
pokojówka	/pɔkɔˈjufka/
próbówka	/pruˈbufka/
stød	/ˈstɛt/
samotność	/s̪äˈmɔtn̪ɔɕt͡ɕ/
szampon	[ˈʃãmpɔ̃n]
hamulec	/xaˈmulɛt͡s̪/
sprzęgło	[ˈs̪pʂɛ̃ŋɡwɔ]
szyba	/ˈʂɨba/
linijka	[ˈlʲiɲijka]
gumka	[ˈɡũmka]
kredka	/ˈkrɛt̪ka/
temperówka	[ˌtɛmpɛˈɾufka]
piórnik	[ˈpʲjurʲɲik]
bigos	[ˈbʲiɡɔs̪]
czako	/ˈt͡ʂakɔ/
ją	[jɔ̃w̃]
Ƶ	/ʐ/
żołądź	[ˈʐ̠ɔwɔ̃ɲt͡ɕ]
grube	/ˈɡrubɛ/
łyżwa	/ˈwɨʐva/
owsiany	[ɔfʲˈɕãn̪ɨ]
obfity	[ɔpˈfʲit̪ɨ]
wyprowadzać	/vɨprɔˈvad͡z̪at͡ɕ/
jarzębina	/jaʐɛmˈbin̪a/
wspominać	/fs̪pɔˈmin̪at͡ɕ/
wspomnieć	/ˈfs̪pɔmɲɛt͡ɕ/
półka	/ˈpuwka/
koci	/ˈkɔt͡ɕi/
intensywny	[ĩn̪t̪ɛ̃ˈs̪ɨvn̪ɨ]
odpowiedzialność	/ɔtpɔvʲɛˈd͡ʑalnɔɕt͡ɕ/
warstwa	[ˈvars̪t̪fa]
koksu	/ˈkɔksu/
idola	/iˈdɔla/
cicho	[ˈt͡ɕixɔ]
głośno	[ˈɡwɔɕn̪ɔ]
głośnik	/ˈɡwɔɕɲik/
prąd	/prɔnt/
tęcza	[ˈt̪ɛnt͡ʂa]
komet	/ˈkɔmɛt/
biznesmen	/ˈbiz̪n̪ɛs̪mɛn̪/
gówno prawda	/ˈɡuv.nɔ ˈprav.da/
dmuchać	/ˈdmu.xatɕ/
jazda	/ˈjazda/
profes	/ˈprɔfɛs/
profesja	/prɔˈfɛsja/
źrebię	/ˈʑrɛbjɛ/
ściągać	[ˈɕt͡ɕɔ̃ŋɡat͡ɕ]
szereg	/ˈʂɛrɛk/
tytan	[ˈtɨtan]
runom	/ˈrunɔm/
runem	/ˈrunɛm/
będą	[ˈbɛ̃n̪d̪ɔ̃w̃]
będę	[ˈbɛ̃n̪d̪ɛ]
śpiący	[ˈɕpʲjɔ̃n̪t͡s̪ɨ]
pośladek	[pɔˈɕladɛk]
fiolet	[fʲɔˈlɛt]
gówienko	[ˈɡuvjɛnkɔ]
grypa	/ˈɡrɨpa/
gryp	/ˈɡrɨp/
psa	/ˈpsa/
stóp	[ˈstup]
ultramaryna	/ul.tra.maˈrɨ.na/
rów	/ˈruf/
dupo	[ˈdupɔ]
odpowiedni	[ɔtpɔˈvjɛdɲi]
klatka	/ˈklatka/
ludożerca	[lud̪ɔˈʐɛrt͡s̪a]
szydło	/ˈʂɨdwɔ/
parne	/ˈparnɛ/
parni	/ˈparɲi/
przyjemny	/pʂɨˈjɛmnɨ/
Antoni	/an̪ˈt̪ɔɲi/
podróż	/ˈpɔd̪ruʂ/
kaptur	/ˈkäptur/
borówka brusznica	/bɔ.ˈru.fkɑ bruʃ.ˈɲi.tsɑ/
horyzont	/xɔˈrɨz̪ɔn̪t̪/
Cyryl	/ˈt͡s̪ɨrɨl/
zaległość	[zaˈlɛɡwɔɕt͡ɕ]
ludzkość	/ˈlutskɔɕt͡ɕ/
Franciszek	/fraɲˈt͡ɕiʂɛk/
Maurycy	/mauˈrɨt͡s̪ɨ/
bakłażan	[baˈkwa.ʐan]
Eryk	/ˈɛrɨk/
zszywka	/ˈs̪ʂɨfka/
grota	/ˈɡrɔta/
głóg	/ɡwuk/
przyzwoitka	[pʂɨ.zvɔˈit.ka]
etyka	[ˈɛtɨka]
etyka	[ɛˈtɨka]
kord	/kɔrt̪/
Ulryk	/ˈulrɨk/
dykcjonarz	/dɨkˈcʲjɔn̪äʂ/
górą	/ˈɡurɔw̃/
próg	/pruk/
piędź	/pʲjɛɲt͡ɕ/
miara	/ˈmjara/
łoże	/ˈwɔʐɛ/
czeladź	/ˈt͡ʂɛlat͡ɕ/
Finlandia	/finˈlandja/
wściekłość	/ˈfɕt͡ɕɛkwɔɕt͡ɕ/
masaż	/ˈmas̪aʂ/
rozeta	/rɔˈzɛta/
Esbjerg	/ˈɛzbjɛr/
Esbjerg	/ˈɛzbjɛrk/
wzór	/ˈvz̪ur/
spis treści	[ˈspʲis ˈtrɛɕt͡ɕi]
susza	/ˈs̪uʂa/
zlew	/ˈz̪lɛf/
zmywarka	[zmɨˈvarka]
stały	[ˈs̪t̪awɨ]
zmienny	/ˈz̪mjɛn̪ːɨ/
polityka	/pɔˈlit̪ɨka/
magnetowid	/maɡn̪ɛˈt̪ɔvit̪/
Inguszetia	[ĩŋɡuˈʂɛt̪ʲja]
Władywostok	/vwa.dɨˈvɔ.stɔk/
rogalik	/rɔˈɡalik/
kajzerka	/kajˈz̪ɛrka/
grahamka	/ɡraˈxamka/
chałka	/ˈxawka/
krówka	/ˈkrufka/
ł	[w]
drób	/ˈd̪rup/
Jolanta	/jɔˈlanta/
przepis	[ˈpʂɛpʲis̪]
smalec	/ˈs̪malɛt͡s̪/
kontrolować	/kɔntrɔˈlɔvat͡ɕ/
kwark	/ˈkfark/
antymateria	[ãn̪t̪ɨ̃maˈt̪ɛrʲja]
mezon	/ˈmɛz̪ɔn̪/
barion	/ˈbarjɔn̪/
bozon	/ˈbɔz̪ɔn̪/
nukleon	/n̪uˈklɛɔn̪/
grawiton	/ɡraˈvit̪ɔn̪/
kwant	/kfan̪t̪/
ocena	/ɔˈt͡s̪ɛn̪a/
Danuta	/d̪aˈn̪ut̪a/
Halina	/xaˈlin̪a/
Bożena	/bɔˈʐɛn̪a/
smarować	/s̪maˈrɔvat͡ɕ/
dziecięcy	[d͡ʑeˈt͡ɕɛ̃n̪t͡s̪ɨ]
dziecinny	[d͡ʑeˈt͡ɕĩn̪ːɨ]
kręcić	/ˈkrɛɲt͡ɕit͡ɕ/
mędrzec	[ˈmɛ̃nd͡ʐʐɛt͡s̪]
żal	[ʐal]
wisienka	/viˈɕɛn̪ka/
Missisipi	/misːiˈsipi/
słoneczny	/s̪wɔˈn̪ɛt͡ʂn̪ɨ/
zdrada	[ˈzdrada]
muszla	/ˈmuʂlä/
spowiedź	[ˈs̪pɔvʲjet͡ɕ]
listwa	[ˈlʲis̪t̪fa]
doniczka	[dɔˈɲit͡ʂka]
wyjąć	/ˈwɨjɔɲt͡ɕ/
wyjmować	/wɨjˈmɔvat͡ɕ/
kawon	/ˈkavɔn̪/
Baszkiria	[baˈʂcirʲja]
Buriacja	[buˈrʲjat͡s̪ʲja]
Czuwaszja	/t͡ʂuˈvaʂja/
Jakucja	[jaˈkut͡s̪ʲja]
Kałmucja	[kawˈmut͡s̪ʲja]
Szkot	/ʂkɔt/
Holenderka	/xɔlɛn̪ˈd̪ɛrka/
Francuz	/ˈfran̪t͡s̪us̪/
Francuzka	/fran̪ˈt͡s̪us̪ka/
naszyjnik	/n̪aˈʂɨjɲik/
poród	/ˈpɔrut̪/
obrona	/ɔˈbrɔn̪a/
bańka	/ˈbaɲka/
sygnał	[ˈs̪ɨɡn̪aw]
powoli	[pɔˈvɔlʲi]
wolno	[ˈvɔln̪ɔ]
opłatek	[ɔˈpwat̪ɛk]
dyftong	[ˈd̪ɨft̪ɔ̃ŋk]
osoby	/ɔˈsɔbɨ/
mówisz	[ˈmuvʲiʂ]
Makau	/maˈka.u/
składnik	/ˈs̪kwad̪ɲik/
Chińczyk	/ˈxʲiɲ.t͡ʂɨk/
Chińczyk	[ˈxʲijn.t͡ʂɨk]
Chinka	[ˈxʲĩn̪ka]
chińczyk	/ˈxʲiɲ.t͡ʂɨk/
chińczyk	[ˈxʲijn.t͡ʂɨk]
tryktrak	/ˈt̪rɨkt̪rak/
inteligentny	/in̪t̪ɛliˈɡɛn̪t̪n̪ɨ/
Słowak	[ˈs̪wɔvak]
Słowaczka	[s̪wɔˈvat͡ʂka]
olbrzym	/ˈɔlbʐɨm/
zakochany	/zakɔˈxanɨ/
ogrom	/ˈɔɡrɔm/
skrzynka	/ˈs̪kʂɨn̪ka/
Atarynka	/ataˈrɨnka/
szczególnie	/ʂt͡ʂɛˈɡulɲɛ/
szeryf	[ˈʂɛrɨf]
cyrk	/ˈt͡s̪ɨrk/
podstawowy	/pɔt͡s̪s̪t̪aˈvɔvɨ/
trzepać	[ˈt.ʂɛpat͡ɕ]
tunel	/ˈt̪un̪ɛl/
zdarzenie	/zdaˈʒɛɲɛ/
pecet	[ˈpɛt͡s̪ɛt̪]
dycha	/ˈd̪ɨxa/
gotówka	/ɡɔˈtufka/
siebie	[ˈɕɛbʲjɛ]
śnić	/ɕɲit͡ɕ/
uderzenie	/ud̪ɛˈʐɛɲɛ/
neologizm	[nɛ.ɔˈlɔ.ɡizm]
podbródek	[pɔdˈbru.dɛk]
płynny	/ˈpwɨn̪ːɨ/
przywódca	[pʂɨˈvut͡s̪t͡s̪a]
Laponia	/laˈpɔɲja/
sałatka	/saˈwat ka/
sałatka	[s̪aˈwat̪ ka]
choroba Alzheimera	[xɔˈɾɔba alt͡sxajˈmɛɾa]
kanion	[ˈkãɲjɔ̃n̪]
wróżka	/ˈvruʂka/
rejestr	[ˈrɛjɛs̪t̪r̥]
myślałam	[mɨˈɕlawãm]
kominek	/kɔˈmin̪ɛk/
rasizm	[ˈraɕis̪m̥]
szachista	[ʂaˈxʲi.s̪t̪a]
tenisistka	/t̪ɛɲiˈɕis̪t̪ka/
hełm	/xewm/
schowek	/ˈs̪xɔvɛk/
Anastazja	/an̪aˈs̪t̪az̪ja/
pięknie	[ˈpʲjɛ̃ŋʲcɲɛ]
Rejkiawik	/ˈrɛjkʲavik/
szwa	/ʂfa/
szabat	/ˈʂabat̪/
szabas	/ˈʂabas̪/
hacham	/ˈxaxam/
khmerski	/ˈkmɛrs̪kʲi/
Słowianin	/s̪wɔˈvjaɲin̪/
więzień	[ˈvʲjẽĩ̯ʑẽɲ]
Phenian	/ˈfɛɲ.jan/
Phenian	/ˈpxɛɲjan̪/
Bałtyk	/ˈbawt̪ɨk/
esemes	/ɛˈs̪ɛmɛs̪/
esemesować	/ˌɛ.sɛ.mɛ.ˈsɔ.vɑtɕ/
rzymski	/ˈʐɨms̪kʲi/
jawor	/ˈjavɔr/
zaklęcie	/z̪aˈklɛɲt͡ɕɛ/
oddech	/ˈɔd̪d̪ɛx/
wstęp	/fs̪t̪ɛmp/
mleć	/ˈmlɛt͡ɕ/
odkrywać	/ɔt̪ˈkrɨvat͡ɕ/
odkryć	/ˈɔt̪krɨt͡ɕ/
usunąć	/uˈs̪un̪ɔɲt͡ɕ/
usuwać	/uˈs̪uvat͡ɕ/
zamknąć	/ˈz̪amkn̪ɔɲt͡ɕ/
wypędzać	/vɨˈpɛn̪d͡z̪at͡ɕ/
wypędzić	/vɨˈpɛɲd͡ʑit͡ɕ/
zasługiwać	/z̪as̪wuˈɡʲivat͡ɕ/
zasłużyć	/z̪aˈs̪wuʐɨt͡ɕ/
zebrać	/ˈz̪ɛbrat͡ɕ/
pąk	[pɔ̃ŋk]
Skopie	/ˈs̪kɔpjɛ/
przedsiębiorca	[pʂɛt͡ɕɕɛ̃mˈbʲjɔrt͡s̪a]
rzeź	/ʐɛɕ/
Grodno	/ˈɡrɔdnɔ/
żyrafy	/ʐɨˈrafɨ/
mewy	/ˈmɛvɨ/
łódka	/ˈwut̪ka/
Budziszyn	/buˈd͡ʑiʂɨn̪/
spiżarnia	/s̪piˈʐarɲa/
Psków	/pskuf/
mędrca	[ˈmɛ̃n̪t̪r̥t͡s̪a]
mędrcze	[ˈmɛ̃n̪t̪r̥t͡ʂɛ]
mędrcy	[ˈmɛ̃n̪t̪r̥t͡s̪ɨ]
kołchoz	/ˈkɔwxɔz/
e-mail	/ˈimɛjl/
frajer	/ˈfrajɛr/
miażdżyca	[mʲjaˈʐd͡ʐɨt͡s̪a]
tętnica	/t̪ɛn̪t̪ˈɲit͡s̪a/
racica	/raˈt͡ɕit͡s̪a/
wzajemny	[vz̪aˈjɛ̃mn̪ɨ]
wzajemnie	[vz̪aˈjɛ̃mʲɲɛ]
twórczy	/ˈtfurt͡ʂɨ/
straszny	[ˈs̪t̪raʂn̪ɨ]
ciąża	[ˈt͡ɕɔ̃nʐa]
był	/ˈbɨw/
trąd	[t̪rɔ̃n̪t̪]
byłem	/ˈbɨwɛm/
byłam	/ˈbɨwam/
byłeś	/ˈbɨwɛɕ/
byłaś	/ˈbɨwaɕ/
ściągnąć	[ˈɕt͡ɕɔ̃ŋɡn̪ɔ̃ɲt͡ɕ]
Małgosia	/mawˈɡɔɕa/
Madzia	/ˈmad͡ʑa/
cię	[t͡ɕɛ]
orać	/ˈɔrat͡ɕ/
rozdział	/ˈrɔz̪d͡ʑaw/
basistka	/baˈɕis̪t̪ka/
nawzajem	[n̪aˈvz̪ajɛ̃m]
wyjątek	/vɨˈjɔn̪t̪ɛk/
filar	[ˈfʲilar]
narta	/ˈnarta/
Mazowsze	/maˈzɔfʂɛ/
dziewczę	/ˈd͡ʑɛft͡ʂɛ/
dziewczęta	/ˈd͡ʑɛft͡ʂɛn̪t̪a/
auć	/awt͡ɕ/
skrzynia	/ˈskʂɨɲa/
całkiem	[ˈt͡s̪awcɛ̃m]
tęsknić	[ˈt̪ɛ̃s̪cɲit͡ɕ]
okropny	/ɔˈkrɔpnɨ/
ustny	/ˈustnɨ/
więc	[vʲjɛ̃n̪t͡s̪]
szkoda	[ˈʂkɔd̪a]
łódzki	/ˈwut͡s̪ci/
wyborca	/vɨˈbɔrtsa/
wystawiać	/vɨsˈtavʲat͡ɕ/
powodzenia	[pɔvɔˈd͡z̪ɛ̃ɲa]
Wielkopolska	/vjɛlkɔˈpɔls̪ka/
zbieg	[z̪bʲjɛk]
nóżka	/ˈn̪uʂka/
pospolity	/pɔspɔˈlʲitɨ/
żonkil	[ˈʐɔ̃ŋʲcil]
ujemny	[uˈjɛmnɨ]
umiejętność	/umjɛˈjɛw̃t̪n̪ɔɕt͡ɕ/
umiejętność	/umjɛˈjɛnt̪n̪ɔɕt͡ɕ/
mięśniowy	[mʲjẽĩ̯ɕˈɲɔvɨ]
umięśniony	[ũmʲjẽĩ̯ɕˈɲɔ̃n̪ɨ]
dziewoja	[d͡ʑɛˈvɔja]
razem	/ˈraz̪ɛm/
wszyscy	[ˈfʂɨs̪t͡s̪ɨ]
wszystkie	[ˈfʂɨs̪t̪cɛ]
gołąbki	/ɡɔˈwɔmpci/
kapuśniak	/kaˈpuɕɲak/
kutia	/ˈkutja/
makowiec	/maˈkɔvjɛt͡s̪/
mizeria	/miˈz̪ɛrja/
uszka	/ˈuʂka/
kabanos	/kaˈban̪ɔs̪/
barok	/ˈbarɔk/
ciąg	[t͡ɕɔ̃ŋk]
równowaga	/ruvn̪ɔˈvaɡa/
chlew	/ˈxlɛf/
ciekły	[ˈt͡ɕɛkwɨ]
cydr	[ˈt͡s̪ɨt̪r̥]
cyfra	/ˈt͡s̪ɨfra/
cygaro	/t͡s̪ɨˈɡarɔ/
cykl	[ˈt͡s̪ɨkl̥]
czkawka	/ˈt͡ʂkafka/
marzenie	/mäˈʐɛ̃ɲɛ/
liniowy	/liˈɲjɔvɨ/
parapetówka	/parapɛˈtufka/
prosto	[ˈprɔs̪t̪ɔ]
dotykać	/d̪ɔˈt̪ɨkat͡ɕ/
dotknąć	/ˈd̪ɔt̪kn̪ɔɲt͡ɕ/
wschodzić	/ˈfsxɔd͡ʑit͡ɕ/
Rysy	/ˈrɨs̪ɨ/
Pomorze	/pɔˈmɔʐɛ/
Kaszuby	/kaˈʂubɨ/
impreza	/imˈprɛz̪a/
Jangcy	[ˈjãŋkt͡s̪ɨ]
Pacyfik	/paˈt͡s̪ɨfik/
leku	[ˈlɛku]
łeb	/wɛp/
robi	[ˈrɔbʲi]
osobno	[ɔˈs̪ɔbn̪ɔ]
oddzielnie	/ɔd͡ʑˈd͡ʑɛlɲɛ/
lotka	[ˈlɔt̪ka]
fujara	[fuˈjara]
historii	[xʲiˈs̪t̪ɔrʲji]
Zbigniew	[ˈz̪bʲiɡʲɲɛf]
Ryszard	[ˈrɨʂart̪]
Wojciech	/ˈvɔjt͡ɕɛx/
Zdzisław	/ˈʑd͡ʑis̪waf/
konwersacja	[kɔnvɛrˈsat͡sja]
rozmawiać	/rɔˈz̪mavjat͡ɕ/
porozmawiać	/pɔrɔˈz̪mavjat͡ɕ/
Jahwe	[ˈjah.fɛ]
bejsbol	/ˈbɛjz̪bɔl/
barometr	/baˈrɔmɛtr/
Bośnia	/ˈbɔɕɲa/
klątwa	/ˈklɔn̪t̪fa/
panie	[ˈpãɲɛ]
średni	/ˈɕrɛdɲi/
nisko	[ˈɲis̪kɔ]
Apolonia	/apɔˈlɔɲja/
Benedykta	/bɛn̪ɛˈd̪ɨkt̪a/
Bogdana	/bɔˈɡd̪an̪a/
jałmużna	[jawˈmuʐn̪a]
odpowiedzialny	[ɔt̪pɔvʲjɛˈd͡ʑaln̪ɨ]
cierpliwie	[t͡ɕɛrˈplʲivʲjɛ]
szafa	/ˈʂafa/
szafka	/ˈʂafka/
hamak	/ˈxamak/
miłego dnia	/miwɛɡɔ d̪ɲa/
niemu	[ˈɲɛ̃mu]
pieg	/pjɛk/
skurwysyn	/s̪kurˈvɨs̪ɨn̪/
lombard	/ˈlɔ̃mbart/
CAF	/ˈkaf/
Bogumiła	/bɔɡuˈmiwa/
Bolesława	/bɔlɛˈs̪wava/
Bronisława	/brɔɲiˈs̪wava/
Brygida	[brɨˈɟid̪a]
Cecylia	/t͡s̪ɛˈt͡s̪ɨlja/
Celestyna	/t͡s̪ɛlɛˈs̪t̪ɨn̪a/
Czesława	/t͡ʂɛˈs̪wava/
Dobrosława	/d̪ɔbrɔˈs̪wava/
góry	/ˈɡurɨ/
górze	/ˈɡuʐɛ/
górę	/ˈɡurɛ/
góro	/ˈɡurɔ/
górom	/ˈɡurɔm/
górami	/ɡuˈrami/
górach	/ˈɡurax/
rurociąg	[ruˈrɔt͡ɕɔ̃ŋk]
pójść	[pujɕt͡ɕ]
burnus	/ˈburnus/
Betlejem	/bɛˈtlɛjɛm/
tachykardia	/t̪axɨˈkard̪ja/
dziobać	/ˈd͡ʑɔbat͡ɕ/
gęsty	[ˈɡɛ̃s̪t̪ɨ]
herc	[xɛrt͡s̪]
lakier	/ˈlakʲɛr/
przelew	/ˈpʂɛlɛf/
gryf	[ɡrɨf]
Ś	/ɕ/
Dauha	/ˈd̪awxa/
filiżanka	[fi.liˈʐaŋ.ka]
zdradzać	[ˈˈzdɾad͡zat͡ɕ]
fortel	[ˈfɔrtɛl]
sąg	[s̪ɔ̃ŋk]
dalej	/ˈdalɛj/
zrozumieć	/zrɔˈzumjɛt͡ɕ/
kardio-	[ˈkardʲjɔ]
gruda	/ˈɡruda/
cip	[ˈt͡ɕip]
suw	/suf/
diament	[ˈɟamɛnt]
szaszłyk	[ˈʂaʂwɨk]
karzeł	/ˈkaʐɛw/
idole	/iˈdɔlɛ/
ABW	[abɛˈvu]
mgławica	[mɡwaˈvʲit͡s̪a]
pleonazm	[plɛˈɔnazm]
opowieść	/ɔˈpɔvʲjɛɕt͡ɕ/
diamentowy	[ɟamɛnˈtɔvɨ]
lniany	[ˈlʲɲãn̪ɨ]
drewniany	[d̪rɛˈvʲɲãn̪ɨ]
Narew	[ˈn̪arɛf]
Noteć	[ˈn̪ɔt̪ɛt͡ɕ]
Pilica	[pʲiˈlʲit͡s̪a]
Wieprz	[ˈvʲjɛpʂ]
Bóbr	[ˈbupr̥]
Łyna	/ˈwɨna/
Wkra	/fkra/
Dunajec	[d̪ũˈn̪ajɛt͡s̪]
psychoza	/psɨˈxɔza/
biurokracja	/bjurɔˈkrat͡s̪ja/
wciąż	[fʲt͡ɕɔ̃(w̃)ʂ]
amharski	/amˈxarsci/
aramejski	/araˈmɛjsci/
Judyta	/juˈdɨta/
piłkarz	ˈpʲiwkaʃ
szalony	[ʂaˈlɔ̃n̪ɨ]
najlepszy	[n̪ajˈlɛpʂɨ]
najtańszy	[n̪ajˈt̪ãĩ̯ʂɨ]
bardziej	[ˈbarʲd͡ʑej]
Pegaz	/ˈpɛɡas/
mróz	/mrus/
zmierzch	[z̪mʲjɛʂx]
puste	/ˈpustɛ/
ostatnio	[ɔˈs̪t̪at̪ʲɲɔ]
trudno	[ˈt̪rud̪n̪ɔ]
łatwo	[ˈwat̪fɔ]
poważnie	/pɔˈvaʐɲɛ/
śmiały	[ˈɕmʲjawɨ]
chora	/ˈxɔra/
poziomo	/pɔˈʑɔmɔ/
jednak	[ˈjɛd̪n̪ak]
golarka	/ɡɔˈlarka/
lokówka	/lɔˈkufka/
serca	[ˈs̪ɛrt͡s̪a]
spokojny	[s̪pɔˈkɔjn̪ɨ]
spokojnie	[s̪pɔˈkɔjɲɛ]
piesek	[ˈpʲjɛs̪ɛk]
pieseczek	[pʲjɛˈs̪ɛt͡ʂɛk]
słodszy	/ˈswɔtʂɨ/
drożsi	[ˈd̪rɔɕːi]
bezie	[ˈbɛʑɛ]
święconka	/ɕvʲɛnˈtsɔnka/
gest	/ɡɛst/
rdzeń	[ɾd͡zɛɲ]
przedsięwzięcie	[pʂɛt͡ɕɕɛ̃w̃ˈvʲʑẽɲt͡ɕɛ]
bodziec	[ˈbɔd͡ʑɛt͡s̪]
Tottenham	/ˈtɔtɛnˌxam/
szmata	/ˈʂma.ta/
szczepionka	[ʂt͡ʂɛˈpʲɔn.ka]
sztandar	[ˈʂtandar]
Oświęcim	[ɔˈɕfʲjɛ̃ɲt͡ɕĩm]
Smoleńsk	[ˈs̪mɔlɛ̃ĩ̯s̪k]
religia	[rɛˈlʲiɟja]
najpierw	[ˈn̪ajpʲjɛrf]
strzał	[stʂaw]
Marsylia	/marˈsɨlja/
Zgorzelec	[z̪ɡɔˈʐɛlɛt͡s̪]
Bogatynia	/bɔɡaˈtɨɲa/
aktualnie	[aktuˈalɲɛ]
Arabka	/aˈrapka/
niuans	[ˈɲu.ans]
boleć	/ˈbɔlɛt͡ɕ/
bielizna	[bʲjɛˈlʲiz̪n̪a]
golić	[ˈɡɔlʲit͡ɕ]
bilard	/ˈbilart/
pretor	/ˈprɛtɔr/
biznes	[ˈbʲiz̪n̪ɛs̪]
delegat	[dɛˈlɛɡat]
szybszy	/ˈʂɨpʂɨ/
lepiej	[ˈlɛpʲjɛ̝j]
stołówka	/stɔˈwufka/
ƶ	/ʐ/
nich	[ɲix]
CONCACAF	/ˈkɔŋkaˌkaf/
oprowadzać	[ɔprɔˈvad͡z̪at͡ɕ]
roku	/ˈrɔku/
skalpel	[ˈskalpɛl]
siadać	[ˈɕad̪at͡ɕ]
ksero	/ˈksɛrɔ/
swojski	/ˈsfɔjski/
Armeńczyk	[arˈmɛ̃ĩ̯nt͡ʂɨk]
kręcenie	/krɛnˈt͡sɛɲɛ/
kazać	/ˈkazat͡ɕ/
niech	[ɲɛx]
krasnal	/ˈkrasnal/
późny	/ˈpuʑn̪ɨ/
spóźniony	[s̪puˈʑɲɔ̃n̪ɨ]
rozwiązanie	[rɔz.viɔ̃ˈza.ɲɛ]
dziewięćset	[ˈd͡ʑɛvjɛŋt͡ɕsɛt]
dwieście	[ˈdvʲɛɕt͡ɕɛ]
trzysta	/ˈtʂɨsta/
sześćset	/ˈʂɛɕsɛt/
sześćset	/ˈʂɛjsɛt/
błysk	/bwɨsk/
ił	/iw/
ląd	/ˈlɔnt/
smoła	/ˈsmɔwa/
zorza	/ˈzɔʐa/
dostać	[ˈd̪ɔs̪t̪at͡ɕ]
przecież	/ˈpʂɛt͡ɕɛʂ/
przecież	[pʂɛːʂ]
propozycja	[prɔ.pɔˈzɨ.t͡sja]
gród	/ˈɡrut/
osiągnięcie	[ɔɕɔ̃ŋˈɟɲẽɲt͡ɕɛ]
eksperyment	[ɛks.pɛˈrɨ.mɛnt]
rozwijać	/rɔˈzvijat͡ɕ/
londyńczyk	[lɔ̃n̪ˈd̪ɨ̃ĩ̯nt͡ʂɨk]
prezentacja	[prɛ.zɛnˈta.t͡sja]
rozkład	[ˈrɔs̪kwat̪]
szczeciński	[ʂt͡ʂɛˈt͡ɕĩĩ̯s̪ʲci]
domowa	/dɔˈmɔva/
marcepan	[marˈt͡s̪ɛpãn̪]
flamandzki	/flaˈmant͡skʲi/
aquapark	[ˈakfapark]
wyłączać	[vɨˈwɔ̃nt͡ʂat͡ɕ]
włączać	[ˈvwɔ̃nt͡ʂat͡ɕ]
kiedykolwiek	[cɛd̪ɨˈkɔlvʲjɛk]
mierzyć	[ˈmʲjɛʐɨt͡ɕ]
lądowisko	[lɔ̃n̪d̪ɔˈvʲis̪kɔ]
Bolesław	/bɔˈlɛs̪waf/
wniosek	/ˈvɲɔs̪ɛk/
zaopatrzenie	[zaɔpaˈtʂɛɲɛ]
wysoko	[vɨˈs̪ɔkɔ]
Gandawa	/ɡan.ˈda.va/
Bronisław	/brɔˈɲis̪waf/
Wientian	/ˈvjɛntjan/
surówka	/suˈrufka/
Boże Ciało	[bɔʐɛˈt͡ɕawɔ]
tony	[ˈt̪ɔ̃n̪ɨ]
zakonnik	/z̪aˈkɔɲːik/
jednocześnie	[jɛd̪n̪ɔˈt͡ʂɛɕɲɛ]
kasownik	/kaˈsɔvɲik/
adwokat diabła	/ˌadˈvɔkat ˈdjabwa/
basior	/ˈbaɕɔr/
przerwa	/ˈpʂɛrva/
wyć	/vɨt͡ɕ/
wędrować	/vɛnˈdrɔvat͡ɕ/
wódz	/vut͡s̪/
wtem	[ˈft̪ɛ̃m]
wstrząs	[fs̪t̪ʂɔ̃s̪]
zamarznięty	[z̪ãmarˈz̪ʲɲɛ̃n̪t̪ɨ]
tułów	[ˈt̪uwuf]
kozi	/ˈkɔʑi/
cipo	[ˈt͡ɕipɔ]
gejsza	/ˈɡɛjʂa/
ojczyzna	[ɔjˈt͡ʂɨz̪n̪a]
miesiączka	[mʲjɛ̝ˈɕɔ̃nt͡ʂka]
poprawiać	/pɔˈpravjat͡ɕ/
poprawić	/pɔˈpravit͡ɕ/
przylot	[ˈpʂɨlɔt̪]
odlot	[ˈɔd̪lɔt̪]
kabała	/kaˈbawa/
cadyk	[ˈt͡s̪ad̪ɨk]
turniej	/ˈt̪urɲɛj/
przynajmniej	/pʂɨˈnajmɲɛj/
gospodarz	[ɡɔˈs̪pɔd̪aʂ]
bose	/ˈbɔsɛ/
apoteoza	/apɔtɛˈɔza/
grej	/ɡrɛj/
dziewięćdziesiąt	[d͡ʑɛvjɛŋˈd͡ʑɛɕɔŋt]
razu	/ˈrazu/
łapa	/ˈwapa/
rób	[rup]
opalowy	/ɔpalˈɔwɨ/
protonem	[prɔˈt̪ɔ̃n̪ɛ̃m]
agawa	/aˈɡava/
awangarda	[avãŋˈɡard̪a]
wydział	/ˈvɨd͡ʑaw/
ryżowy	/rɨˈʒɔvɨ/
czosnkowy	[t͡ʂɔs̪n̪̊ˈkɔvɨ]
pseudohodowla	/ˌpsɛwdɔxɔˈdɔvla/
pseudonauka	[ˌpsɛwdɔ̃naˈwuka]
siać	[ɕat͡ɕ]
nieźle	[ˈɲɛʑlɛ]
jałówka	/jaˈwufka/
rzeczy	[ˈʐɛt͡ʂɨ]
kablówka	/kaˈblufka/
klonowy	/klɔˈnɔvɨ/
zeszły	[zɛʂwɨ]
stosunek	/stɔˈsunɛk/
pewny	[ˈpɛvn̪ɨ]
karafka	/kaˈrafka/
sprzęt	[s̪pʂɛ̃n̪t̪]
choć	/xɔt͡ɕ/
wymyślić	/vɨˈmɨɕ.lit͡ɕ/
czule	[ˈt͡ʂulɛ]
brata	[ˈbrat̪a]
limburski	/limˈbursci/
dalszy	/ˈdalʂɨ/
siogun	/ˈɕɔɡun̪/
szogun	/ˈʂɔɡun̪/
półrocze	/puwˈrɔt͡ʂɛ/
Dubaj	/ˈdubaj/
nurt	/nurt/
łowca	/ˈwɔft͡s̪a/
twórca	/ˈtfurt͡s̪a/
arytmetyczny	[arɨt̪mɛˈt̪ɨt͡ʂn̪ɨ]
zapalić	/zaˈpalit͡ɕ/
szmaragd	/ˈʂmäräɡd/
poliester	[pɔˈlʲi.ʔɛ.stɛr]
spotkać	/ˈspɔtkat͡ɕ/
henr	[xɛ̃n̪r̥]
siwert	/ˈsivɛrt/
inaczej	[ĩˈn̪at͡ʂɛj]
Wietnamczyk	[vʲjɛt̪ˈn̪ãmt͡ʂɨk]
wkrótce	[ˈfkrut̪t͡s̪ɛ]
delikatny	/dɛliˈkatnɨ/
czepek	/ˈt͡ʂɛpɛk/
kąpielówki	/kɔmpjɛˈlufci/
kontusz	/ˈkɔntuʂ/
kitel	[ˈcit̪ɛl]
ładnie	/ˈwadɲɛ/
lwów	[lvuf]
tańsi	[ˈt̪ãĩ̯ɕi]
finał	/ˈfinaw/
ateistka	[ˌatɛˈjistka]
biliard	[ˈbʲilʲjart̪]
macie	/ˈmat͡ɕɛ/
akapit	[aˈkapʲit̪]
papużka	/paˈpuʂka/
jarmuż	/ˈjarmuʂ/
siarkowy	[ɕarˈkɔvɨ]
mysi	/ˈmɨɕi/
bosy	/ˈbɔsɨ/
montaż	/ˈmɔntaʂ/
bronie	[ˈbrɔ̃ɲɛ]
łódeczka	[wuˈd̪ɛt͡ʂka]
borowy	/bɔˈrɔvɨ/
liceum	/liˈt͡s̪ɛum/
wyrób	/ˈvɨrup/
sierpniowy	[ɕɛrˈpʲɲɔvɨ]
lutowy	/luˈtɔvɨ/
majowy	/maˈjɔvɨ/
kąpiel	/ˈkɔmpjɛl/
żel	/ʐɛl/
maszyną	[maˈʂɨ̃n̪ɔ̃w̃]
metalowy	/mɛtaˈlɔvɨ/
młodszy	[ˈmwɔt͡ʂʂɨ]
szeroko	[ʂɛˈrɔkɔ]
spojrzenie	/s̪pɔjˈʐɛɲɛ/
słabo	[ˈs̪wabɔ]
uczucie	/uˈt͡ʂut͡ɕɛ/
pęknięcie	[pɛ̃ŋˈcɲẽɲt͡ɕɛ]
ślad	[ɕlat̪]
szprot	[ʂprɔt̪]
elektrolit	/ɛlɛˈktrɔlit/
lont	[lɔ̃nt]
milczeć	[ˈmʲilt͡ʂɛt͡ɕ]
mowa	[ˈmɔva]
jedynie	/jɛˈdɨɲɛ/
aktorzy	/akˈtɔʐɨ/
krokodyli	[krɔ.kɔˈdɨ.li]
moją	[ˈmɔjɔ̃w̃]
krajem	[ˈkrajɛ̃m]
zapewniać	/zaˈpɛvɲat͡ɕ/
strzecha	/ˈst͡ʂɛxa/
żołna	/ˈʐɔwna/
świetność	[ˈɕfʲjɛt̪n̪ɔɕt͡ɕ]
stęp	/ˈstɛmp/
strzemię	/ˈst.ʂɛmjɛ/
wędzidło	[vɛ̃ɲˈd͡ʑid̪wɔ]
popręg	[ˈpɔprɛ̃ŋk]
czaprak	/ˈt͡ʂaprak/
nowo	/ˈnɔvɔ/
karmel	/ˈkarmɛl/
rybny	/ˈrɨbnɨ/
pysk	/pɨsk/
gazetowy	/ɡazɛˈtɔvɨ/
gryka	/ˈɡrɨka/
topolowy	/tɔpɔˈlɔvɨ/
gwizdek	[ˈɡvizdɛk]
dzielny	[ˈd͡ʑɛln̪ɨ]
dachy	/ˈdaxɨ/
duchowy	/duˈxɔvɨ/
duchach	/ˈduxax/
parzysty	/paˈʐɨstɨ/
ług	/wuk/
chorobowy	/xɔrɔˈbɔvɨ/
otworzyć	/ɔˈtfɔʐɨt͡ɕ/
moralny	/mɔˈralnɨ/
morał	/ˈmɔraw/
brutalnie	/bruˈtalɲɛ/
arystokratyczny	[arɨs̪t̪ɔkraˈt̪ɨt͡ʂn̪ɨ]
glon	/ɡlɔn/
glonowy	/ɡlɔˈnɔvɨ/
Padwa	/ˈpadva/
Asyż	/ˈasɨʂ/
warzucha	/vaˈʐuxa/
barokowy	/barɔˈkɔvɨ/
kartonowy	/kartɔˈnɔvɨ/
rezus	/ˈrɛzus/
brodate	/brɔˈdatɛ/
brodata	/brɔˈdata/
kapryśny	/kaˈprɨɕnɨ/
rytm	/rɨtm/
sokowirówka	/sɔkɔviˈrufkä/
okna	/ˈɔkna/
podpalacz	[pɔt̪ˈpalat͡ʂ]
aczkolwiek	[at͡ʂˈkɔlvʲjɛk]
kryterium	[krɨˈtɛrʲjum]
Akwitania	[akfiˈtaɲa]
wrzos	/vʐɔs/
Antwerpia	/antˈfɛrpja/
wałach	/ˈvawax/
chorych	/ˈxɔrɨx/
szybsi	/ˈʂɨpɕi/
głupszy	/ˈɡwupʂɨ/
starszy	/ˈstarʂɨ/
Tygrys	/ˈtɨɡrɨs/
panach	/ˈpanax/
paniach	/ˈpaɲax/
orła	/ˈɔrwa/
fosforowy	/fɔsfɔˈrɔvɨ/
krzemowy	/kʂɛˈmɔvɨ/
doradca	[d̪ɔˈrat͡s̪t͡s̪a]
zawodowy	/zavɔˈdɔvɨ/
mam pytanie	/mam pɨˈt̪aɲɛ/
w ogóle	/vɔˈɡulɛ/
w ogóle	/ˈvɔɡlɛ/
krawędź	[ˈkravɛ̃ɲt͡ɕ]
marze	/ˈmaʐɛ/
fristajlowiec	/ˌfristajˈlɔvjɛt͡s̪/
spożywczy	[s̪pɔˈʐɨft͡ʂɨ]
toć	[t̪ɔt͡ɕ]
umięśnieni	[ũmʲjẽĩ̯ɕˈɲẽɲi]
nieskończony	/ɲɛ.skɔɲˈt͡ʂɔ.nɨ/
kosiarka	[kɔˈɕarka]
nioska	[ˈɲɔs̪ka]
odpływ	[ˈɔt̪pwɨf]
przypływ	[ˈpʂɨpwɨf]
mają	[ˈmajɔ̃w̃]
miałem	[ˈmʲjawɛ̃m]
miałam	[ˈmʲjawãm]
miałeś	[ˈmʲjawɛɕ]
miałaś	[ˈmʲjawaɕ]
miała	[ˈmʲjawa]
miało	[ˈmʲjawɔ]
mieliśmy	[ˈmʲjɛlʲiɕmɨ]
burdelmama	/ˈbur.d̪ɛl.ˌma.ma/
chcesz	[xt͡s̪ɛʂ]
chce	[xt͡s̪ɛ]
chcemy	[ˈxt͡s̪ɛ̃mɨ]
chcecie	[ˈxt͡s̪ɛt͡ɕɛ]
chcą	[xt͡s̪ɔ̃w̃]
chciałem	[ˈxʲt͡ɕawɛ̃m]
chciałam	[ˈxʲt͡ɕawãm]
chciałeś	/ˈxt͡ɕawɛɕ/
chciał	[ˈxʲt͡ɕaw]
chciała	[ˈxʲt͡ɕawa]
chciałbym	[ˈxʲt͡ɕawbɨ̃m]
chciałabym	[ˈxʲt͡ɕawabɨ̃m]
mogę	/ˈmɔɡɛ/
możesz	[ˈmɔʐɛʂ]
możemy	[ˈmɔʐɛ̃mɨ]
możecie	[mɔˈʐɛt͡ɕɛ]
mogą	[ˈmɔɡɔ̃w̃]
mogłem	[ˈmɔɡwɛ̃m]
mógł	[mukw̥]
mógłbym	[ˈmuɡwbɨ̃m]
mógłbyś	[ˈmuɡwbɨɕ]
mógłby	[ˈmuɡwbɨ]
musisz	[ˈmuɕiʂ]
musimy	[muˈɕĩmɨ]
musicie	[muˈɕit͡ɕɛ]
muszą	[ˈmuʂɔ̃w̃]
musiałem	[muˈɕawɛ̃m]
musiał	[ˈmuɕaw]
chodzi	[ˈxɔd͡ʑi]
chodźmy	[ˈxɔt͡ɕmɨ]
chodźcie	[ˈxɔt͡ɕt͡ɕɛ]
stało	[ˈs̪t̪awɔ]
stój	[s̪t̪uj]
robisz	[ˈrɔbʲiʂ]
robimy	[rɔˈbʲĩmɨ]
robią	[ˈrɔbʲjɔ̃w̃]
w porządku	[fpɔˈʐɔ̃n̪t̪ku]
ludzi	[ˈlud͡ʑi]
pewnie	/ˈpɛvɲɛ/
pomóc	/ˈpɔmut͡s̪/
kocham	[ˈkɔxãm]
życia	[ˈʐɨt͡ɕa]
rację	[ˈrat͡s̪ʲjɛ]
dni	[d̪ʲɲi]
nadzieję	[n̪aˈd͡ʑejɛ]
nocy	[ˈn̪ɔt͡s̪ɨ]
napisy	[n̪aˈpʲis̪ɨ]
gdybym	[ˈɡd̪ɨbɨ̃m]
gdybyś	[ˈɡd̪ɨbɨɕ]
chwilę	/ˈxfilɛ/
pomocy	/pɔˈmɔt͡s̪ɨ/
ciągle	[ˈt͡ɕɔ̃ŋɡlɛ]
sprawy	[ˈs̪pravɨ]
końcu	[ˈkɔ̃ĩ̯n̪t͡s̪u]
powodu	[pɔˈvɔd̪u]
miejscu	[ˈmʲjejs̪t͡s̪u]
życiu	[ˈʐɨt͡ɕu]
właściwie	/vwaˈɕt͡ɕivjɛ/
świecie	[ˈɕfʲjet͡ɕɛ]
śmierci	[ˈɕmʲjɛrʲt͡ɕi]
parę	/ˈparɛ/
diabła	[ˈd̪ʲjabwa]
kobiety	[kɔˈbʲjɛt̪ɨ]
miejsca	[ˈmʲjejs̪t͡s̪a]
cholery	[xɔˈlɛrɨ]
sprawę	[ˈs̪pravɛ]
prawdę	[ˈpravd̪ɛ]
szybciej	[ˈʂɨpʲt͡ɕej]
dopiero	[d̪ɔˈpʲjɛrɔ]
pieniędzy	[pʲjẽˈɲɛ̃n̪d͡z̪ɨ]
człowieka	[t͡ʂwɔˈvʲjɛka]
dolarów	[d̪ɔˈlaruf]
słowa	[ˈs̪wɔva]
fajnie	[ˈfajɲɛ]
fajno	[ˈfajn̪ɔ]
wcześniej	[ˈft͡ʂɛɕɲej]
wrócić	[ˈvrut͡ɕit͡ɕ]
godziny	[ɡɔˈd͡ʑĩn̪ɨ]
chwili	[ˈxfʲilʲi]
nowego	[n̪ɔˈvɛɡɔ]
ziemi	[ˈʑɛ̃mʲi]
raczej	[ˈrat͡ʂɛj]
dziewczyny	/d͡ʑɛˈft͡ʂɨnɨ/
chłopaki	[xwɔˈpaci]
doktorze	[d̪ɔˈkt̪ɔʐɛ]
godzin	[ˈɡɔd͡ʑĩn̪]
świata	[ˈɕfʲjat̪a]
powrotem	[pɔˈvrɔt̪ɛ̃m]
powrót	/ˈpɔvrut/
kapitanie	[kapʲiˈt̪ãɲɛ]
głowy	[ˈɡwɔvɨ]
rodziny	[ˈrɔd͡ʑĩn̪ɨ]
środku	[ˈɕrɔt̪ku]
małpeczka	[mawˈpɛt͡ʂka]
małpka	[ˈmawpka]
chusteczka	/xusˈt̪ɛt͡ʂkä/
pojęcia	[pɔˈjẽɲt͡ɕa]
skarbie	[ˈs̪karbʲjɛ]
głowę	[ˈɡwɔvɛ]
krwi	[kr̥fʲi]
miasta	[ˈmʲjas̪t̪a]
końca	[ˈkɔ̃ĩ̯n̪t͡s̪a]
uwierzyć	[uˈvʲjɛʐɨt͡ɕ]
drodze	[ˈd̪rɔd͡z̪ɛ]
szkoły	[ˈʂkɔwɨ]
wyjaśnić	/vɨˈjaɕɲit͡ɕ/
wyjaśniać	/vɨˈjaɕɲat͡ɕ/
składać	[ˈs̪kwad̪at͡ɕ]
złożyć	[ˈz̪wɔʐɨt͡ɕ]
tędy	[ˈt̪ɛ̃n̪d̪ɨ]
kędy	[ˈkɛ̃n̪d̪ɨ]
nikędy	[ɲiˈkɛ̃n̪d̪ɨ]
eurodance	/ˌɛwrɔˈdɛ̃s/
wiadomości	[vʲjad̪ɔˈmɔɕt͡ɕi]
przeczytać	[pʂɛˈt͡ʂɨt̪at͡ɕ]
myślę	[ˈmɨɕlɛ]
myślisz	[ˈmɨɕlʲiʂ]
myśli	[ˈmɨɕlʲi]
myślałem	[mɨˈɕlawɛ̃m]
myślał	[ˈmɨɕlaw]
wędka	[ˈvɛ̃n̪t̪ka]
odkąd	[ˈɔt̪kɔ̃n̪t̪]
będziesz	[ˈbɛ̃ɲd͡ʑɛʂ]
będzie	[ˈbɛ̃ɲd͡ʑɛ]
będziemy	[bɛ̃ɲˈd͡ʑɛ̃mɨ]
będziecie	[bɛ̃ɲˈd͡ʑet͡ɕɛ]
byliśmy	/ˈbɨliɕmɨ/
byliście	/ˈbɨliɕt͡ɕɛ/
byłyśmy	/ˈbɨwiɕmɨ/
byłyście	/ˈbɨwɨɕt͡ɕɛ/
byłoby	[ˈbɨwɔbɨ]
boże	[ˈbɔʐɛ]
mojego	[mɔˈjɛɡɔ]
mojej	[ˈmɔjej]
moich	/ˈmɔ.ix/
mojemu	[mɔˈjɛ̃mu]
moim	/ˈmɔ.im/
moimi	/mɔˈimi/
twojego	[t̪fɔˈjɛɡɔ]
twoich	[ˈt̪fɔ.ix]
twojemu	[t̪fɔˈjɛ̃mu]
twoim	[ˈt̪fɔ.ĩm]
twoimi	[t̪fɔˈĩmʲi]
twoi	[ˈt̪fɔ.i]
twoją	[ˈt̪fɔjɔ̃w̃]
swoi	[ˈs̪fɔ.i]
swojego	[s̪fɔˈjɛɡɔ]
swoich	[ˈs̪fɔ.ix]
swojemu	[s̪fɔˈjɛ̃mu]
swoim	[ˈs̪fɔ.ĩm]
swoją	[ˈs̪fɔjɔ̃w̃]
swoimi	[s̪fɔˈĩmʲi]
nasze	[ˈn̪aʂɛ]
nasza	[ˈn̪aʂa]
naszego	[n̪aˈʂɛɡɔ]
naszej	[ˈn̪aʂɛj]
naszych	[ˈn̪aʂɨx]
naszemu	[n̪aˈʂɛ̃mu]
naszym	[ˈn̪aʂɨ̃m]
naszą	[ˈn̪aʂɔ̃w̃]
naszymi	[n̪aˈʂɨ̃mʲi]
wasze	[ˈvaʂɛ]
wasza	[ˈvaʂa]
waszego	[vaˈʂɛɡɔ]
waszej	[ˈvaʂɛj]
waszych	[ˈvaʂɨx]
waszemu	[vaˈʂɛ̃mu]
waszym	[ˈvaʂɨ̃m]
waszą	[ˈvaʂɔ̃w̃]
waszymi	[vaˈʂɨ̃mʲi]
którzy	[ˈkt̪uʐɨ]
którego	[kt̪uˈrɛɡɔ]
której	[ˈkt̪urɛj]
których	[ˈkt̪urɨx]
któremu	[kt̪uˈrɛ̃mu]
którym	[ˈkt̪urɨ̃m]
którą	[ˈkt̪urɔ̃w̃]
którymi	[ˈkt̪urɨ̃mʲi]
jacy	[ˈjat͡s̪ɨ]
jakiego	[jaˈcɛɡɔ]
jakiej	[ˈjacej]
jakich	[ˈjacix]
jakiemu	[jaˈcɛ̃mu]
jakim	[ˈjacĩm]
jaką	[ˈjakɔ̃w̃]
jakimi	[jaˈcimʲi]
każdego	[kaˈʐd̪ɛɡɔ]
każdej	[ˈkaʐd̪ɛj]
każdemu	[ˈkaʐd̪ɛ̃mu]
każdym	[ˈkaʐd̪ɨ̃m]
każdą	[ˈkaʐd̪ɔ̃w̃]
panu	[ˈpãn̪u]
panowie	[pãˈn̪ɔvʲjɛ]
sobą	[ˈs̪ɔbɔ̃w̃]
najbardziej	[n̪ajˈbarʲd͡ʑej]
innego	[ĩˈn̪ːɛɡɔ]
innej	[ˈĩn̪ːɛj]
innych	[ˈĩn̪ːɨx]
innemu	[ĩˈn̪ːɛ̃mu]
innym	[ˈĩn̪ːɨ̃m]
inną	[ˈĩn̪ːɔ̃w̃]
innymi	[ĩˈn̪ːɨ̃mʲi]
dobrego	[dɔˈbrɛɡɔ]
dobrym	[ˈd̪ɔbrɨ̃m]
dużego	[duˈʐɛɡɔ]
wystarczy	[vɨˈs̪t̪art͡ʂɨ]
całym	[ˈt͡s̪awɨ̃m]
całą	[ˈt͡s̪awɔ̃w̃]
cokolwiek	[t͡s̪ɔˈkɔlvʲjɛk]
jednego	[jɛˈd̪n̪ɛɡɔ]
należy	[n̪aˈlɛʐɨ]
według	[ˈvɛd̪wuk]
ponad	[ˈpɔn̪at̪]
sprawdzić	[ˈs̪pravʲd͡ʑit͡ɕ]
trzymać	[ˈt͡ʂʂɨ̃mat͡ɕ]
potrzebuję	[pɔt͡ʂʂɛˈbujɛ]
czeka	[ˈt͡ʂɛka]
czekaj	[ˈt͡ʂɛkaj]
wielu	/ˈvʲɛlu/
kilkaset	/ˈcilkasɛt/
wyglądasz	[vɨˈɡlɔ̃n̪d̪aʂ]
wygląda	[vɨˈɡlɔ̃n̪d̪a]
słucham	[ˈs̪wuxãm]
słuchaj	[ˈs̪wuxaj]
nazywam	[n̪aˈz̪ɨvãm]
nazywa	[n̪aˈz̪ɨva]
gramy	/ˈɡramɨ/
znam	[z̪n̪ãm]
znasz	[z̪n̪aʂ]
zna	[z̪n̪a]
pamiętam	[pãˈmʲjɛ̃n̪t̪ãm]
pamiętasz	[pãˈmʲjɛ̃n̪t̪aʂ]
wracam	[ˈvrat͡s̪ãm]
wracaj	[ˈvrat͡s̪aj]
uważam	[uˈvaʐãm]
uważaj	[uˈvaʐaj]
potrzebujesz	[pɔt͡ʂʂɛˈbujɛʂ]
potrzebuje	[pɔt͡ʂʂɛˈbujɛ]
potrzebujemy	[pɔt͡ʂʂɛbuˈjɛ̃mɨ]
proste	[ˈprɔs̪t̪ɛ]
złota	/ˈzwɔta/
pracuję	[praˈt͡s̪ujɛ]
zrobię	[ˈz̪rɔbʲjɛ]
zrobisz	[ˈz̪rɔbʲiʂ]
zrobi	[ˈz̪rɔbʲi]
zrobimy	[z̪rɔˈbʲĩmɨ]
zrobiłem	[z̪rɔˈbʲiwɛ̃m]
zrobiłam	[z̪rɔˈbʲiwãm]
zrobiłeś	[z̪rɔˈbʲiwɛɕ]
zrobiłaś	[z̪rɔˈbʲiwaɕ]
zrobił	[ˈz̪rɔbʲiw]
zrobiła	[z̪rɔˈbʲiwa]
zrobiłabym	[z̪rɔˈbʲiwabɨ̃m]
zrobiłabyś	[z̪rɔˈbʲiwabɨɕ]
zrobiłaby	[z̪rɔˈbʲiwabɨ]
zrób	[z̪rup]
pierwsze	[ˈpʲjɛrfʂɛ]
pierwsza	[ˈpʲjɛrfʂa]
zaczyna	[z̪aˈt͡ʂɨ̃n̪a]
gotowanie	/ɡɔt̪ɔˈväɲɛ/
tatuujący	[ta.tuːˈjɔŋ.t͡sɨ]
tatuujący	[ta.tu.ʔuˈjɔŋ.t͡sɨ]
trzymaj	[ˈt͡ʂʂɨ̃maj]
sprzedasz	/ˈs̪pʂɛd̪aʂ/
posłuchaj	[pɔˈs̪wuxaj]
zaufany	/z̪a.uˈfa.nɨ/
zaufanie	/z̪a.uˈfa.ɲɛ/
policji	[pɔˈlʲit͡s̪ʲji]
nieważne	[ɲɛˈvaʐn̪ɛ]
laskach	[ˈlaskax]
łaskach	[ˈwaskax]
drugiej	[ˈd̪ruɟej]
kozie	[ˈkɔʑɛ]
ostatnie	[ɔˈs̪t̪at̪ʲɲɛ]
psie	/ˈpʲɕɛ/
okazji	[ɔˈkaz̪ʲji]
źdźbło	[ʑd͡ʑbwɔ]
zauważyć	/z̪a.uˈva.ʐɨt͡ɕ/
złotówka	[z̪wɔˈt̪ufka]
łada	[ˈwad̪a]
lekko	/ˈlɛk.kɔ/
miło	[ˈmʲiwɔ]
marynarz	/maˈrɨnaʂ/
jak masz na imię	/ˌjak maʂ n̪a ˈimjɛ/
jak się masz	/jak ɕɛ ˈmaʂ/
fałsz	/fawʂ/
felga	/ˈfɛlɡa/
razy	[ˈraz̪ɨ]
widać	[ˈvʲid̪at͡ɕ]
wietrzny	[ˈvʲjɛt.ʂn̪ɨ]
doliczony czas	/dɔliˈt͡ʂɔnɨ t͡ʂas/
regulaminowy czas	/rɛɡulamʲiˈnɔvɨ t͡ʂas/
rozpoczęcie meczu	/rɔspɔˈt͡ʂɛɲt͡ɕɛ ˈmɛt͡ʂu/
rozpoczęcie spotkania	/rɔspɔˈt͡ʂɛɲt͡ɕɛ spɔˈtkaɲa/
kamieniarz	/kaˈmʲɛɲaʂ/
lustrzanka	[luˈs̪t.ʂãn̪ka]
obcas	[ˈɔpt͡s̪as̪]
tobą	[ˈt̪ɔbɔ̃w̃]
wam	[vãm]
tobie	[ˈt̪ɔbʲjɛ]
zajebisty	[z̪ajɛˈbʲis̪t̪ɨ]
wstążka	[ˈfs̪t̪ɔ̃ʂka]
tymi	[ˈt̪ɨ̃mʲi]
tych	[t̪ɨx]
płód	[pwut̪]
wierzę	[ˈvʲjɛʐɛ]
radę	[ˈrad̪ɛ]
rękę	[ˈrɛ̃ŋkɛ]
zdjęcia	[ˈz̪d̪ʲjɛ̃ɲt͡ɕa]
drogę	[ˈd̪rɔɡɛ]
szansę	[ˈʂã(w̃)s̪ɛ]
dziewczynę	[d͡ʑɛfˈt͡ʂɨ̃n̪ɛ]
godzinę	[ɡɔˈd͡ʑĩn̪ɛ]
uwagę	[uˈvaɡɛ]
ziemię	[ˈʑɛmʲjɛ]
żonę	[ˈʐɔ̃n̪ɛ]
obiecuję	[ɔbʲjɛˈt͡s̪ujɛ]
słyszę	[ˈs̪wɨʂɛ]
wolę	[ˈvɔlɛ]
co to jest	/t͡s̪ɔ t̪ɔ ˈjɛs̪t̪/
cudownie	[t͡s̪uˈd̪ɔvʲɲɛ]
na razie	[n̪aˈraʑɛ]
seria rzutów karnych	/ˈsɛrʲja ˈʐutuf ˈkarnɨx/
ciemno	/ˈt͡ɕɛmnɔ/
płci	[pwuˈt͡ɕi]
Ałtaj	/ˈawtaj/
bawić	/ˈbavit͡ɕ/
można	[ˈmɔʐn̪a]
wieczorem	[vʲjɛˈt͡ʂɔrɛ̃m]
toku	/ˈtɔku/
arytmetyka	[arɨˈt̪mɛt̪ɨka]
słód	[s̪wut̪]
Gaja	/ˈɡaja/
pojazd	[ˈpɔjas̪t̪]
przyjaźnie	/pʂɨˈjaʑɲɛ/
buziak	/ˈbuʑak/
bezpieczeństwo	[bɛspʲɛˈʈ͡ʂɛɲstfɔ]
wymię	/ˈvɨmʲjɛ/
łono	/ˈwɔn̪ɔ/
zdanie podrzędne	/ˈzdaɲɛ pɔdˈʐɛ̃dnɛ/
aalborski	/ɔlˈbɔrskʲi/
Genk	/xɛŋk/
Brabancja Północna	/braˈbant͡sja puwˈnɔt͡sna/
Fryzja	/ˈfrɨzja/
Limburgia	/limˈburɟja/
Geldria	/ˈɡɛldrja/
Geldria	/ˈxɛldrja/
Holandia Północna	/xɔˈlandʲja puwˈnɔt͡sna/
Holandia Południowa	/xɔˈlandʲja pɔwudˈɲɔva/
Flandria Wschodnia	/ˈflandrʲa fsˈxɔdɲa/
Flandria Zachodnia	/ˈflandrʲa zaˈxɔdɲa/
Brabancja Walońska	/braˈbant͡sja vaˈlɔ̃ɲska/
Brabancja Flamandzka	/braˈbant͡sja flaˈmant͡ska/
Luksemburgia	/luksɛmˈburɟja/
lesba	[ˈlɛz.ba]
ginekolog	/ɟin̪ɛˈkɔlɔk/
północnobrabancki	/puwˌnɔt͡snɔbraˈbant͡skʲi/
wschodnioflamandzki	/fsˌxɔdɲɔflaˈmant͡skʲi/
zachodnioflamandzki	/zaxɔdˌɲɔflaˈmant͡skʲi/
geldryjski	/ɡɛlˈdrɨjskʲi/
geldryjski	/xɛlˈdrɨjskʲi/
groningski	/xrɔˈɲiŋski/
utrechcki	/ˈutrɛxt͡skʲi/
zelandzki	/zɛˈlant͡skʲi/
ekstremalny	[ɛks̪t̪rɛ̃ˈmaln̪ɨ]
wtóry	[ˈft̪urɨ]
akademicki	/akadɛˈmit͡ski/
ratusz	/ˈratuʂ/
wzwód	[vz̪vut̪]
niedaleko	[ɲɛd̪aˈlɛkɔ]
skąpy	[ˈs̪kɔ̃mpɨ]
gołębię	[ɡɔˈwɛ̃mbʲjɛ]
szuler	[ˈʂulɛr]
niewidomy	[ɲɛvʲiˈd̪ɔ̃mɨ]
niewidoma	[ɲɛvʲiˈd̪ɔ̃ma]
pamiętnik	[pãˈmʲjɛ̃n̪t̪ʲɲik]
blady	/ˈbladɨ/
's-Hertogenbosch	/ˌsɛrtɔxɛmˈbɔs/
's-Hertogenbosch	/ˌsɛrtɔxɛˈbɔs/
Den Bosch	/dɛn ˈbɔs/
śmiało	[ˈɕmʲjawɔ]
dary	[ˈdarɨ]
ojczysty	[ɔjˈt͡ʂɨs̪t̪ɨ]
dawno	[ˈd̪avn̪ɔ]
pory	/ˈpɔrɨ/
prenumerata	/prɛn̪umɛˈrat̪a/
zdążyć	[ˈz̪d̪ɔ̃(w̃)ʐɨt͡ɕ]
spróbować	/spruˈbɔvat͡ɕ/
rzucać	/ˈʐut͡s̪at͡ɕ/
rzucić	/ˈʐut͡ɕit͡ɕ/
sznur	[ʂn̪ur]
pchać	[pxat͡ɕ]
syte	/ˈsɨtɛ/
zachować	/zaˈxɔvat͡ɕ/
ukryć	/ˈukrɨt͡ɕ/
podnieść	[ˈpɔd̪ʲɲeɕt͡ɕ]
wrażliwy	/vraˈʐlivɨ/
daszek	[ˈd̪aʂɛk]
tyłek	/ˈt̪ɨwɛk/
wątpię	/ˈvɔn̪t̪pjɛ/
mówię	/ˈmuvjɛ/
widzę	[ˈvʲid͡z̪ɛ]
czuję	[ˈt͡ʂujɛ]
lubię	[ˈlubʲjɛ]
idę	[ˈid̪ɛ]
sądzę	[ˈs̪ɔ̃n̪d͡z̪ɛ]
widzisz	[ˈvʲid͡ʑiʂ]
rozumiesz	[rɔˈz̪ũmʲjɛʂ]
idziesz	[ˈid͡ʑɛʂ]
lubisz	[ˈlubʲiʂ]
słyszysz	[ˈs̪wɨʂɨʂ]
sądzisz	[ˈs̪ɔ̃ɲd͡ʑiʂ]
patrzę	/ˈpat͡ʂʂɛ/
wieku	[ˈvʲjɛku]
tygodniu	[t̪ɨˈɡɔd̪ʲɲu]
miłości	[mʲiˈwɔɕt͡ɕi]
wojny	[ˈvɔjn̪ɨ]
czyż	[t͡ʂɨʂ]
gorąco	[ɡɔˈrɔ̃n̪t͡s̪ɔ]
malarka	/maˈlarka/
śmieciarz	[ˈɕmʲjɛ̝t͡ɕaʂ]
cipka	[ˈt͡ɕipka]
daj	/daj/
bliźnię	[ˈblʲiʑɲɛ]
bliźnięta	[blʲiˈʑɲɛ̃n̪t̪a]
dziewka	/ˈd͡ʑɛfka/
maty	/ˈmatɨ/
Kopt	/kɔpt/
rur	[rur]
otyły	[ɔˈt̪ɨwɨ]
sułtan	[ˈs̪uwt̪ãn̪]
obiecuje	[ɔbʲjɛˈt͡s̪ujɛ]
łąk	[wɔ̃ŋk]
miauczeć	[ˈmʲjawt͡ʂɛt͡ɕ]
literówka	/lit̪ɛˈrufka/
mieszanka	[mʲɛˈʂãn̪ka]
pestkowiec	[pɛs̪t̪ˈkɔvʲjɛt͡s̪]
łysi	[ˈwɨɕi]
łyse	/ˈwɨsɛ/
łysa	/ˈwɨsa/
łysą	[ˈwɨs̪ɔ̃w̃]
ciebie	[ˈt͡ɕɛbʲjɛ]
enklawa	[ɛ̃ŋˈklava]
tę	[t̪ɛ]
tą	[t̪ɔ̃w̃]
sprawie	[ˈs̪pravʲjɛ]
świąt	[ɕfʲjɔ̃n̪t̪]
patrz	[pat.ʂ]
patrz	[pat͡ʂ.ʂ]
weź	/vɛɕ/
zamknij	[ˈz̪ãmcɲij]
mów	/muf/
idź	[it͡ɕ]
powiedz	[ˈpɔvʲjɛt͡s̪]
martw	/martf/
małe	/ˈmawɛ/
kraju	/ˈkraju/
zobacz	[ˈz̪ɔbat͡ʂ]
zadzwoń	[ˈz̪ad͡z̪vɔ̃ɲ]
dajcie	[d̪ajt͡ɕɛ]
mówi	[ˈmuvʲi]
znaczy	[ˈz̪n̪at͡ʂɨ]
żyje	/ˈʐɨjɛ/
idziemy	[iˈd͡ʑɛ̃mɨ]
wiemy	[ˈvʲjɛ̃mɨ]
idzie	[ˈid͡ʑɛ]
mówią	[ˈmuvʲjɔ̃w̃]
wiecie	[ˈvʲjet͡ɕɛ]
brzmi	[bʐmʲi]
wybaczyć	[vɨˈbat͡ʂɨt͡ɕ]
wybacz	[ˈvɨbat͡ʂ]
lubi	[ˈlubʲi]
wiedzą	[ˈvʲjɛd͡z̪ɔ̃w̃]
spróbuj	/ˈsprubuj/
zapomnij	[z̪aˈpɔ̃mʲɲij]
otwórz	/ˈɔtfuʂ/
pomoże	/pɔˈmɔʐɛ/
dasz	/daʂ/
wstawaj	/ˈfstavaj/
widzi	[ˈvʲid͡ʑi]
potrafi	[pɔˈt̪rafʲi]
został	[ˈz̪ɔs̪t̪aw]
mówiłem	[muˈvʲiwɛ̃m]
powiedziałem	[pɔvʲjeˈd͡ʑawɛ̃m]
widziałem	[vʲiˈd͡ʑawɛ̃m]
słyszałem	[s̪wɨˈʂawɛ̃m]
trzeba	[ˈtʂɛba]
leczyć	[ˈlɛt͡ʂɨt͡ɕ]
albinizm	[alˈbʲĩɲis̪m̥]
alarmy	/aˈlarmɨ/
jedenaścioro	/jɛd̪ɛn̪aɕˈt͡ɕɔɾɔ/
dwanaścioro	/d̪van̪aɕˈt͡ɕɔɾɔ/
trzynaścioro	/t̪.ʂɨn̪aɕˈt͡ɕɔɾɔ/
czternaścioro	/t͡ʂt̪ɛɾn̪aɕˈt͡ɕɔɾɔ/
piętnaścioro	/pʲjɛt̪n̪aɕˈt͡ɕɔɾɔ/
szesnaścioro	/ʂɛs̪n̪aɕˈt͡ɕɔɾɔ/
siedemnaścioro	/ɕɛd̪ɛmn̪aɕˈt͡ɕɔɾɔ/
osiemnaścioro	/ɔɕɛmn̪aɕˈt͡ɕɔɾɔ/
dziewiętnaścioro	/d͡ʑɛvʲɛt̪n̪aɕˈt͡ɕɔɾɔ/
dwadzieścioro	/d̪vad͡ʑɛɕˈt͡ɕɔɾɔ/
głów	/ɡwuf/
skądś	[s̪kɔ̃n̪t̪ʲɕ]
ślepa	/ˈɕlɛpa/
ślepe	/ˈɕlɛpɛ/
skrzydełko	[s̪kʂɨˈd̪ɛwkɔ]
udko	[ˈut̪kɔ]
kory	/ˈkɔrɨ/
hokejowy	/xɔkɛˈjɔvɨ/
razie	/ˈraʑɛ/
taksówkarz	/taˈksufkaʂ/
cieśnina	[t͡ɕeˈɕɲĩn̪a]
aresztować	[arɛˈʂt̪ɔvat͡ɕ]
kilowatogodzina	[cilɔvat̪ɔɡɔˈd͡ʑĩn̪a]
archaizm	[arˈxa.is̪m̥]
tokach	/ˈtɔkax/
małych	/ˈmawɨx/
grze	/ɡʐɛ/
formalny	/fɔrˈmalnɨ/
zawodowo	/zavɔˈdɔvɔ/
prałat	/ˈprawat/
gada	[ˈɡada]
Charków	[ˈxarkuf]
Lewandowski	[lɛvãɲˈd̪ɔfs̪ʲci]
Kowalczyk	[kɔˈvalt͡ʂɨk]
Kamiński	[kãˈmʲĩĩ̯s̪ʲci]
Zieliński	[ʑɛˈlĩĩ̯s̪ʲci]
Szymański	[ʂɨˈmãĩ̯s̪ʲci]
Woźniak	[ˈvɔʑɲak]
Jankowski	[jãn̪ˈkɔfs̪ʲci]
Mazur	[ˈmaz̪ur]
Zając	[ˈz̪ajɔ̃n̪t͡s̪]
Zalewski	[z̪aˈlɛfs̪ʲci]
Wieczorek	[vʲjɛˈt͡ʂɔrɛk]
Szczęsny	[ˈʂt͡ʂɛ̃w̃s̪n̪ɨ]
Polański	[pɔˈlãĩ̯s̪ʲci]
Błaszczykowski	[bwaʂt͡ʂɨˈkɔfs̪ʲci]
pasat	[ˈpasat]
cug	[t͡suk]
powóz	/ˈpɔvus/
ruszać	[ˈruʂat͡ɕ]
biesiada	[bʲjeˈɕad̪a]
torebka	[t̪ɔˈrɛpka]
śmieci	[ˈɕmʲjet͡ɕi]
malowidło	[malɔˈvʲid̪wɔ]
uratować	[uraˈt̪ɔvat͡ɕ]
brony	[ˈbrɔnɨ]
oprócz	[ˈɔprut͡ʂ]
sportu	/ˈspɔrtu/
batonik	[baˈtɔ.ɲik]
niezwykły	[ɲɛˈz̪vɨkwɨ]
miasteczko	[mʲjaˈs̪t̪ɛt͡ʂkɔ]
spomiędzy	[s̪pɔ̃ˈmʲjɛ̃n̪d͡z̪ɨ]
spośród	[ˈs̪pɔɕrut̪]
sponad	[ˈs̪pɔ̃n̪at̪]
znad	[z̪n̪at̪]
spoza	[ˈs̪pɔz̪a]
pośród	[ˈpɔɕrut̪]
wyszukiwarka	[vɨʂuciˈvarka]
wycieczka	[vɨˈt͡ɕɛt͡ʂka]
łuku	/ˈwuku/
Tetyda	/tɛˈtɨda/
jajach	/ˈjajax/
jelito	[jɛˈlʲit̪ɔ]
kał	/kaw/
jeżówka	/jɛˈʐufka/
pewnych	/ˈpɛvnɨx/
częściej	[ˈʈ͡ʂɛ̃ɕt͡ɕɛj]
najgorszy	/najˈɡɔrʂɨ/
zimna	/ˈʑimna/
zwykła	/ˈzvɨkwa/
psów	/psuf/
popojutrze	[pɔpɔˈjut.ʂɛ]
możesz mi pomóc	/ˌmɔʐɛʂ mi ˈpɔmut͡s̪/
wyraźny	[vɨˈraʑn̪ɨ]
masyw	/ˈmasɨf/
huj	/xuj/
głuptak	[ˈɡwupt̪ak]
czernica	[t͡ʂɛˈrʲɲit͡s̪a]
potrzos	[ˈpɔt͡ʂ.ʂɔs̪]
ohar	[ˈɔxar]
białorzytka	[bʲjawɔˈʐɨt̪ka]
barw	/barf/
adygejski	[ad̪ɨˈɡɛjs̪ʲci]
Adygeja	[ad̪ɨˈɡɛja]
Kabardo-Bałkaria	[kaˈbard̪ɔ bawˈkarʲja]
Karaczajo-Czerkiesja	[karaˈt͡ʂajɔ t͡ʂɛrˈcɛs̪ja]
Mordwa	[ˈmɔrd̪va]
Tuwa	[ˈt̪uva]
Udmurcja	[uˈd̪murt͡s̪ʲja]
Chakasja	[xaˈkas̪ʲja]
cipy	[ˈt͡ɕipɨ]
cipie	[ˈt͡ɕipʲɛ]
cipom	[ˈt͡ɕipɔm]
cipę	[ˈt͡ɕipɛ]
cipą	[ˈt͡ɕipɔ̃]
cipami	[t͡ɕiˈpamʲi]
cipach	[ˈt͡ɕipax]
obłąkany	[ɔbwɔ̃ŋˈkãn̪ɨ]
wysiąść	[ˈvɨɕɔ̃ĩ̯ɕt͡ɕ]
kurwy	/ˈkurvɨ/
kurew	[ˈkurɛf]
kurwie	[ˈkurvʲɛ]
kurwom	[ˈkurvɔm]
myć się	[ˈmɨt͡ɕɕɛ]
umyć się	/ˈumɨt͡ɕɕɛ/
nerwowo	[n̪ɛrˈvɔvɔ]
żyroskop	/ʐɨˈrɔskɔp/
kabardyjski	/kabarˈd̪ɨjs̪ci/
golić się	[ˈɡɔlʲit͡ɕɕɛ]
ogolić się	[ɔˈɡɔlʲit͡ɕɕɛ]
dunajski	[dũˈnajsʲci]
cząber	[ˈt͡ʂɔ̃mbɛr]
gorczyca	[ɡɔrˈt͡ʂɨt͡s̪a]
lubczyk	[ˈlupt͡ʂɨk]
prasować	[praˈs̪ɔvat͡ɕ]
wyprasować	[vɨpraˈs̪ɔvat͡ɕ]
bezbarwny	[bɛz̪ˈbarvn̪ɨ]
ciekawski	[t͡ɕɛˈkafsʲ̪ci]
użyszkodnik	[u.ʐɨˈʂkɔd.ɲik]
strumień	[ˈs̪t̪rũmʲjɛ̝̃ɲ]
więcierz	[ˈvʲjɛ̃ɲt͡ɕɛʂ]
garnek	[ˈɡarn̪ɛk]
ulicę	/uˈlit͡sɛ/
ulicy	/uˈlit͡sɨ/
ulico	/uˈlit͡sɔ/
zabrać	[ˈz̪abrat͡ɕ]
zatrzymać	[z̪aˈt͡ʂʂɨ̃mat͡ɕ]
pogadać	[pɔˈɡad̪at͡ɕ]
odejść	[ˈɔd̪ɛjɕt͡ɕ]
odchodzić	[ɔt̪ˈxɔd͡ʑit͡ɕ]
zostawić	[z̪ɔˈs̪t̪avʲit͡ɕ]
pozwolić	[pɔˈz̪vɔlʲit͡ɕ]
uderzać	[uˈd̪ɛʐat͡ɕ]
zniknąć	[ˈz̪ɲikn̪ɔ̃ɲt͡ɕ]
kaucja	/ˈkawt͡s̪ja/
uciążliwy	[ut͡ɕɔ̃w̃ˈʐlʲivɨ]
miło mi cię poznać	/miwɔ mi t͡ɕɛ pɔz̪n̪at͡ɕ/
maślanka	[maˈɕlãn̪ka]
drzemka	/ˈd.ʐɛmka/
uczelnia	[uˈt͡ʂɛlʲɲa]
gęba	[ˈɡɛ̃mba]
szerszy	/ˈʂɛrʂɨ/
słabszy	/ˈswapʂɨ/
weselszy	/ˈwɛsɛlʂɨ/
Bałt	/bawt/
Łotysz	/ˈwɔtɨʂ/
Łotyszka	/wɔˈtɨʂka/
wołać	[ˈvɔwat͡ɕ]
ssij	/sɕij/
ssij	/ɕːij/
palmowy	/palˈmɔvɨ/
kurzawka	/kuˈʐafka/
kartkówka	[kart̪ˈkufka]
Almería	/ˌalmɛˈrija/
Almeríi	/ˌalmɛˈriji/
Almeríę	/ˌalmɛˈrijɛ/
Almeríą	/ˌalmɛˈrijɔ̃/
Almerío	/ˌalmɛˈrijɔ/
Hefajstos	/xɛˈfajstɔs/
toster	/ˈtɔstɛr/
Synaj	/ˈsɨnaj/
wózek	/ˈvuzɛk/
kaktusowy	/kaktuˈsɔvɨ/
kolejarz	/kɔˈlɛjaʂ/
karnawałowy	/karnavaˈwɔvɨ/
żabach	/ˈʐabax/
kolarz	/ˈkɔlaʂ/
kolaż	/ˈkɔlaʂ/
podróżnik	[pɔˈd̪ruʐɲik]
wór	[vur]
brzemię	/ˈbʐɛmʲjɛ/
Izyda	/iˈzɨda/
herbaciarnia	[xɛrbaˈt͡ɕarʲɲa]
stypendium	[s̪t̪ɨˈpɛ̃n̪d̪ʲjũm]
czystość	[ˈt͡ʂɨstɔɕt͡ɕ]
rzyć	[ʐɨt͡ɕ]
ponownie	[pɔ̃ˈn̪ɔvʲɲɛ]
mamrotać	[mãˈmrɔt̪at͡ɕ]
prawdopodobny	[pravd̪ɔpɔˈd̪ɔbn̪ɨ]
kontynentalny	/kɔn̪t̪ɨn̪ɛn̪ˈt̪äln̪ɨ/
topory	/tɔˈpɔrɨ/
halabarda	/xalaˈbaɾda/
przykładowo	/pʂɨkwaˈdɔvɔ/
błahy	/ˈbwaxɨ/
Szarlota	[ʂarˈlɔta]
nie-	/ɲɛ/
prosię	/ˈprɔɕɛ/
mowach	/ˈmɔvax/
boraks	/ˈbɔraks/
oczęta	[ɔˈt͡ʂɛ̃n̪t̪a]
nienasycony	[ɲɛ̃n̪as̪ɨˈt͡s̪ɔ̃n̪ɨ]
Template:pl-IPA/documentation	[ʂt͡ʂɨˈpʲɔ.rɛk]
romboedr	[rɔ̃mˈbɔɛt̪r̥]
rzeczywisty	[ʐɛt͡ʂɨˈvʲis̪t̪ɨ]
hokejówka	[xɔkɛˈjufka]
ortograficzny	[ɔrt̪ɔɡraˈfʲit͡ʂn̪ɨ]
prawdopodobnie	[pravd̪ɔpɔˈd̪ɔbʲɲɛ]
strzelec	/ˈs̪t̪ʂɛlɛt͡s̪/
milczący	[mʲilˈt͡ʂɔnt͡sɨ]
świerszczyk	[ˈɕfʲɛr.ʂt͡ʂɨk]
niepotrzebny	[ɲɛpɔtˈʂɛbnɨ]
wkurwiać	/ˈfkurvjat͡ɕ/
użyć	[ˈuʐɨt͡ɕ]
rodu	[ˈrɔdu]
obszerny	[ɔˈpʂɛrn̪ɨ]
apetyt	[aˈpɛtɨt]
rozsądek	[rɔˈs̪ːɔ̃n̪d̪ɛk]
odżywka	[ɔd͡ʐˈʐɨf.ka]
klimatyzacja	/klimat̪ɨˈz̪at͡s̪ja/
warsztat	[ˈvarʂt̪at̪]
przeciwny	[pʂɛˈt͡ɕivn̪ɨ]
-owy	[ˈɔvɨ]
świr	[ˈɕfir]
wszech-	[fʂɛx]
wszechwiedza	[fʂɛxˈvʲɛ.d͡za]
kocię	[ˈkɔt͡ɕiɛ̃]
nadobny	[ˈnadobn̪ɨ]
dwoisty	[dvɔˈis.tɨ]
praelement	[pra.ɛˈlɛ.mɛnt]
czarodziej	/t͡ʂaˈrɔd͡ʑɛj/
plansza	[ˈplaŋ.ʂa]
wihajster	[vʲiˈxajstɛr]
bunkier	[ˈbũŋʲcɛr]
szwindel	[ˈʃfʲĩndɛl]
arfa	[ˈarfa]
księga	[ˈkɕɛŋ.ɡa]
kurort	[ˈkurɔrt]
foryś	[ˈfɔrɨɕ]
zamsz	[zãmʃ]
strefa	[ˈstrɛfa]
garnirunek	[ˌɡarʲɲiˈrũnɛk]
-unek	[ũnɛk]
asenterunek	[ˌasɛ̃ntɛˈrũnɛk]
basarunek	[ˌbasaˈrũnɛk]
ładunek	[waˈdũnɛk]
meldunek	[mɛlˈdũnɛk]
pakunek	[paˈkũnɛk]
tratwa	/ˈtratfa/
potrawa	/pɔˈtrava/
muza	[ˈmuza]
szalotka	[ʂaˈlɔtka]
schować	[ˈsxɔvat͡ɕ]
gaś	[ɡaɕ]
myl	[mɨl]
mył	[mɨw]
owady	[oˈvadɨ]
kajaku	[kaˈjaku]
bałtosłowiański	/ˌbaw.tɔ.swɔˈvʲaɲ.ski/
górnoniemiecki	/ˌɡur.nɔ.ɲɛˈmʲɛt͡s.ki/
przez grzeczność nie zaprzeczę	/ˌpʂɛs ˈɡʐɛt͡ʂ.nɔɕt͡ɕ ɲɛ zapˈʂɛ.t͡ʂɛ/
zajekurwabiście	[za.jɛˌkur.vaˈbiɕ.t͡ɕɛ]
Łazarz	/ˈwazaʂ/
rzekomo	[ʐɛˈkɔmɔ]
siusiak	[ˈɕu.ɕak]
żreć	/ʐrɛt͡ɕ/
kaczę	[ˈka.t͡ʂɛ̃]
podatkowy	[ˌpɔdatˈkɔvɨ]
dodatkowy	[ˌdɔdatˈkɔvɨ]
żaru	[ˈʐaru]
husyta	[xuˈsɨta]
husytyzm	[xuˈsɨtɨzm]
libański	[lʲiˈbãj̃sʲci]
kardamon	[karˈdãmɔ̃n]
prawa zwierząt	[ˈprava ˈzvʲjɛʒɔ̃nt]
buddysta	[buˈdːɨ.sta]
buddystka	[budˈːɨstka]
niewiara	[ŋɛˈvʲjara]
buddyjski	[budˈːɨjsʲci]
wertykalny	[ˌvɛrtɨˈkalnɨ]
naukowy	[ˌnauˈkɔvɨ]
histeryk	[çiˈstɛrɨk]
wojna religijna	[ˈvɔjna ˌrɛlʲiˈɟijna]
jajowaty	[ˌjäjɔˈvatɨ]
weganka	[vɛˈɡãnka]
wojewoda	[ˌvɔjɛˈvɔda]
Syzyf	[ˈsɨzɨf]
jurajski	/juˈrajski/
Alę	/ˈalɛ/
szkwał	[ʂkfaw]
powiedział	[pɔvˈʲjed͡ʑaw]
tyle	[ˈtɨlɛ]
Rzeczpospolita	/ʐɛt͡ʂ.pɔˈspɔ.lʲi.ta/
Delfy	[ˈdɛlfɨ]
trzech	[t͡ʂʂɛx]
nienaturalny	[ɳɛnatuˈralnɨ]
matach	/ˈmatax/
jebać się	[ˈjɛbat͡ɕ ɕɛ]
najebać się	[naˈjɛbat͡ɕ ɕɛ]
z groszami	/zɡrɔˈʂa.mi/
perz	[pɛʂ]
Smalc	/ˈs̪malt͡s̪/
Smalcjusz	/ˈs̪malt͡s̪juʂ/
Szmalc	/ˈʂmalt͡s̪/
dała	[ˈdawa]
kuś	[kuɕ]
korsarz	[ˈkɔrsaʂ]
Teby	[ˈtɛbɨ]
kuśnierz	[ˈkuɕɲɛʂ]
jednakowy	[ˌjɛdnaˈkɔvɨ]
niżej	[ˈɲiʐɛj]
wyżej	[ˈvɨʐɛj]
pały	[ˈpawɨ]
trzykrotka	[tʂɨˈkrotka]
Kadyks	[ˈkadɨks]
hongkoński	[hɔŋˈkɔɲ.ski]
kłykieć	[ˈkwɨkʲɛt͡ɕ]
Ł	[w]
wiła	/ˈviwa/
przyganiał kocioł garnkowi	[pʂɨˈɡa.ɲaw ˈkɔ.t͡ɕɔw ɡarnˈkɔ.vi]
krów	[kruf]
WKU	/vu.kaˈu/
inside joby	/ˌinsajd ˈd͡ʐɔbɨ/
inside joba	/ˌinsajd ˈd͡ʐɔba/
inside jobie	/ˌinsajd ˈd͡ʐɔbje/
inside jobowi	/ˌinsajd d͡ʐɔˈbɔvi/
inside jobem	/ˌinsajd ˈd͡ʐɔbɛm/
inside jobów	/ˌinsajd ˈd͡ʐɔbuf/
inside jobom	/ˌinsajd ˈd͡ʐɔbɔm/
inside jobami	/ˌinsajd d͡ʐɔˈbami/
inside jobach	/ˌinsajd ˈd͡ʐɔbax/
ciuch	t͡ɕux
ujebać	[uˈjɛ.bat͡ɕ]
czarnuch	[t͡ʂarnux]
bazylia	[baˈzɨlʲja]
źródlany	[ʑruˈdla.nɨ]
jak słoń w składzie porcelany	[ˈjak ˈswɔɲ ˈf͜skwad͡ʑɛ ˌpɔrt͡sɛˈlanɨ]
pustak	[ˈpus.tak]
mistyfikacja	[ˌmis.tɨ.fiˈkat͡s.ja]
pałować	[paˈwɔ.vat͡ɕ]
psisko	[ˈpɕis.kɔ]
współczesny standardowy język arabski	/vspuwˈt͡ʂɛsnɨ standarˈdɔvɨ ˈjɛ̃zɨk aˈrapskʲi/
współczesnego standardowego języka arabskiego	/vspuwt͡ʂɛˈsnɛɡɔ standardɔˈvɛɡɔ jɛ̃ˈzɨka arapˈskʲɛɡɔ/
współczesnemu standardowemu językowi arabskiemu	/vspuwt͡ʂɛˈsnɛmu standardɔˈvɛmu jɛ̃zɨˈkɔvi arapˈskʲɛmu/
współczesnym standardowym językiem arabskim	/vspuwˈt͡ʂɛsnɨm standarˈdɔvɨm jɛ̃ˈzɨkʲɛm aˈrapskʲim/
współczesny standardowy języku arabski	/vspuwˈt͡ʂɛsnɨ standarˈdɔvɨ jɛ̃ˈzɨku aˈrapskʲi/
współczesnym standardowym języku arabskim	/vspuwˈt͡ʂɛsnɨm standarˈdɔvɨm jɛ̃ˈzɨku aˈrapskʲim/
rozpuszczalnik	[rɔs.puʂˈt͡ʂal.ɲik]
murzać	[ˈmur.zaɕ]
lisię	[ˈliɕɛ]
śpioch	[ɕpʲjɔx]
niechże	[ˈɲeɣʐɛ]
chirurgia kosmetyczna	[çi.rurˈɟa kɔs.mɛˈtɨt͡ʂ.na]
chirurgia plastyczna	[çi.rurˈɟa plaˈstɨt͡ʂ.na]
chirurgia estetyczna	[çi.rurˈɟa ɛ.stɛˈtɨt͡ʂ.na]
dławik	[ˈd̪wavʲik]
w chuj	[f͜xuj]
ciemno jak w dupie u Murzyna	/ˈt͡ɕem.nɔ ˈjaɡ ˈv͜du.pʲje u͜.muˈʐɨ.na/
znamię	/ˈz̪n̪amʲjɛ̃/
ni chuja	[niˈxu.ja]
ni chuja	[ni.xuˈja]
głupi jak but	[ˈɡwu.pi jaɡ but]
szpaler	[ˈʃpalɛr]
cytwar	[ˈt͡sɨtfar]
grajcar	[ˈɡrajt͡sar]
kafar	[ˈkafar]
sztygar	[ˈʃtɨɡar]
idiotoodporny	[iˌdʲɔ.tɔ.ʔɔtˈpɔr.nɨ]
idiotoodporny	[iˌdʲɔ.tɔːtˈpɔr.nɨ]
ognioodporny	[ˌɔɡ.ɲɔ.ʔɔtˈpɔr.nɨ]
ognioodporny	[ˌɔɡ.ɲɔːtˈpɔr.nɨ]
mrozoodporny	[ˌmrɔ.zɔ.ʔɔtˈpɔr.nɨ]
mrozoodporny	[ˌmrɔ.zɔ.ːtˈpɔr.nɨ]
OSP	[ɔ.ʔɛsˈpɛ]
paszoł won	[paˈʂow ˈvɔn]
paszoł won	[ˌpa.ʂowˈvɔn]
udawać Greka	[uˈda.vad͡ʑ ˈɡrɛ.ka]
budżetówka	[bud.ʐɛˈtuf.ka]
budżetówka	[bud͡ʐ.ʐɛˈtuf.ka]
puszcza	[ˈpuʂt͡ʂa]
EZT	[ˈɛ.zɛt]
EZT	[ˈɛ ˈzɛt ˈtɛ]
esesman	[ɛsˈɛs.man]
kułak	[kuˈwak]
Kułak	[kuˈwak]
-ów	[uf]
ą-ę	/ʔɔ̃ʔɛ̃/
ę-ą	/ʔɛ̃ʔɔ̃/
rozwój	[ˈrɔz̪vuj]
nosił wilk razy kilka, ponieśli i wilka	[ˈnɔ.ɕiw vilk ˈra.zɨ ˈkil.ka, pɔˈɲɛɕ.li i ˈvil.ka]
klops	[klɔps]
pulpet	[ˈpulpɛt]
licealista	/litsɛaˈlista/
licealistka	/litsɛaˈlistka/
Edyp	[ˈɛdɨp]
na wynos	/naˈvɨ.nɔs/
most wiszący	[mɔzd viˈʂɔŋ.t͡sɨ]
most zwodzony	[mɔzd zvɔˈd͡zɔ.nɨ]
bić się z myślami	[bit͡ɕ ɕɛ̃ z͜mɨɕˈla.mi]
sprzątnąć sprzed nosa	[ˈspʂɔnt.nɔɲt͡ɕ spʂɛd͜ˈnɔ.sa]
żenua	[ʐɛ.nuˈa]
nie od razu Rzym zbudowano	[ɲɛ ɔd͜ˈra.zu ʐɨm zbu.dɔˈva.nɔ]
od razu	/ɔd͜ˈra.zu/
niedwuznaczny	[ɲɛ.dvuˈznat͡ʂ.nɨ]
porywać się z motyką na słońce	[pɔˈrɨ.vat͡ɕ ɕɛ̃ z͜mɔˈtɨ.kɔ̃ na ˈswɔɲ.t͡sɛ]
porwać się z motyką na słońce	[ˈpɔr.vat͡ɕ ɕɛ̃ z͜mɔˈtɨ.kɔ̃ na ˈswɔɲ.t͡sɛ]
puścić z torbami	[ˈpuɕ.t͡ɕit͡ɕ s͜tɔrˈba.mi]
blachosmród	[blaˈxɔ.smrut]
krzywoprzysięstwo	[kʂɨ.vɔ.pʂɨˈɕɛŋ.stfɔ]
gżegżółka	[ɡʐɛˈɡʐuwka]
uderz w stół, a nożyce się odezwą	[ˈu.dɛʂ f͜stuw a nɔˈʐɨ.t͡sɛ ɕɛ̃ ɔˈdɛz.vɔ̃]
wlec	[vlɛt͡s]
gmina miejsko-wiejska	[ˈɡmi.na ˈmʲɛj.skɔ ˈvʲɛj.ska]
sranie w banię	[ˈsra.ɲɛ ˈv͜ba.ɲɛ]
zmarszczka	[ˈzmarʃt͡ʃka]
miąć	[mʲjɔɲt͡ɕ]
gnieść	[ɡʲɲɛɕt͡ɕ]
wykopalisko	[vɨkɔpaˈliskɔ]
darowanemu koniowi nie zagląda się w zęby	[da.rɔ.vaˈnɛ.mu kɔˈɲɔ.vi ɲɛ zaɡˈlɔn.da ɕɛ ˈv͜zɛm.bɨ]
GDDKiA	[ɡʲɛ.dɛ.dɛ.kaˈi.ʔa]
GDDKiA	[ɡʲɛ.dɛ.dɛ.kaˈi.a]
pleć	[plɛt͡ɕ]
barachło	/baraxˈwɔ/
wizja	[ˈvi.zja]
wygłup	[ˈvɨ.ɡwup]
uprawa	[uˈpra.va]
krytyczny	[krɨˈtɨt͡ʂ.nɨ]
odmienny	[ɔdˈmjɛn.nɨ]
antywirus	[an.tɨˈvi.rus]
hodowla	[hɔˈdɔvla]
edycja	[ɛˈdɨt͡sja]
szyk	[ˈʂɨk]
leżak	[ˈlɛʐak]
rejestracja	[rɛjɛˈstrat͡sʲja]
jaźń	[ˈjaʑɲ]
liściowy	[liɕˈt͡ɕɔvɨ]
szpinakowy	[ʂpinaˈɔvɨ]
lustrzany	[lusˈtʂa.nɨ]
międzygwiezdny	[mʲjɛn.d͡zɨˈɡvʲjɛzd.nɨ]
konfitura	[kɔ̃n.fiˈtu.ra]
ostrzałka	[ɔsˈtʂaw.ka]
darowizna	[da.rɔˈviz.na]
wyświetlać	[vɨˈɕfʲjɛ.tlat͡ɕ]
brakować	[braˈkɔ.vat͡ɕ]
eksperymentować	[ɛks.pɛ.rɨ.mɛnˈtɔ.vat͡ɕ]
badać	[ˈba.dat͡ɕ]
treść	[ˈtrɛɕt͡ɕ]
szelka	[ˈʂɛl.ka]
powiadomienie	[pɔ.vʲja.dɔˈmʲjɛ.ɳɛ]
imitacja	[i.mʲiˈta.t͡sʲja]
drzazga	[ˈdʐaz.ɡa]
nawiedzony	[na.vʲjɛˈd͡zɔ.nɨ]
biszkopt	[ˈbʲiʃ.kɔpt]
pojawiać się	[pɔˈjavʲjat͡ɕ‿ɕɛ]
pojawić się	[pɔˈjavʲit͡ɕ‿ɕɛ]
kruchszy	[ˈkruxʂɨ]
najkruchszy	[najˈkruxʂɨ]
notariusz	[nɔˈta.rjuʂ]
prawdziwych przyjaciół poznaje się w biedzie	[pravˈd͡ʑi.vɨx pʂɨˈja.t͡ɕuw pɔzˈna.jɛ ɕɛ ˈv͜bʲjɛ.d͡ʑɛ]
człowieczeństwo	[t͡ʂwɔvʲ.jɛˈt͡ʂɛĩ̯s̪t̪fɔ]
Jaś	/jaɕ/
bezwzględny	[bɛzˈvzɡlɛn.dnɨ]
odbijać	/ɔdˈbʲijat͡ɕ/
odbić	/ˈɔdbʲit͡ɕ/
działalność	/d͡ʑaˈwalnɔɕt͡ɕ/
drąg	/drɔŋk/
eł	/ɛw/
eś	/ɛɕ/
żet	/ʐɛt̪/
lotnictwo	[lɔtˈnit͡svɔ]
kubeł	/ˈkubɛw/
proga	[ˈprɔɡa]
kolokwium	[kɔˈlɔkfium]
jawić się	[ˈjavʲit͡ɕ‿ɕɛ]
zginąć	/ˈzɡʲinɔɲt͡ɕ/
fonetyczka	[fɔnɛˈtɨt͡ʂka]
pozostawać	/ˌpɔzɔˈstavat͡ɕ/
pozostać	/pɔˈzɔstat͡ɕ/
wobec	/ˈvɔbɛt͡s/
pochodzenie	/ˌpɔxɔˈdz͡ɛɲɛ/
odkryty	/ˈɔt̪krɨtɨ/
pochodzić	/pɔˈxɔd͡ʑit͡ɕ/
klejnot	/ˈklɛjn̪ɔt̪/
nadzór	/ˈnad͡z.zur/
nadzorca	/nad͡zˈzɔr.t͡sa/
wianek	/ˈvʲjanɛk/
ślepy zaułek	[ˈɕlɛ.pɨ zaˈu.wɛk]
czarnoksiężnik	/t͡ʂar.nɔˈkɕɛŋʐ.ɲik/
drobny	/ˈdrɔbnɨ/
lżyć	/lʒɨt͡ɕ/
gamratka	/ɡãmˈratka/
posiedzenie	/ˌpɔɕɛˈd͡zɛɲɛ/
szadź	/ʂät͡ɕ/
chrupek	/ˈxrupɛk/
dochodzenie	/ˌdɔxɔˈd͡zɛɲɛ/
wystarczająco	/ˌvɨstart͡ʃaˈjɔnt͡sɔ/
Ziemi	[ˈʑɛ̃mʲi]
Ziemię	[ˈʑɛmʲjɛ]
proboszcz	/ˈprɔ.bɔʂʈ͡ʂ/
nocnik	/nɔt͡sɲik/
opryskliwy	/ˌɔprɨskˈlʲivɨ/
wózek inwalidzki	[ˈvuzɛk ˌĩnvaˈlʲit͡sʲci]
Suchy	[ˈs̪uxɨ]
Ptak	/pt̪ak/
Kolenda	/kɔˈlɛn̪d̪a/
Kolęda	/kɔˈlɛn̪d̪a/
Szczur	[ʂʈ͡ʂur]
-iec	/jɛt͡s/
Motyl	[ˈmɔt̪ɨl]
Żmija	[ˈʐmʲija]
Rolnik	/ˈrɔlɲik/
Piasek	/ˈpʲjäsɛk/
Ziemniak	/ˈʑɛmɲak/
Dzięcioł	/ˈd͡ʑɛɲt͡ɕɔw/
Wąż	[vɔ̃w̃ʂ]
Sokół	[ˈs̪ɔkuw]
Słaby	[ˈs̪wabɨ]
Silny	[ˈɕiln̪ɨ]
Sójka	[ˈs̪ujka]
Zaucha	/z̪aˈuxa/
Szalony	[ʂaˈlɔ̃n̪ɨ]
Ciemny	/ˈt͡ɕɛmn̪ɨ/
Tłusty	/ˈt̪wus̪t̪ɨ/
Czarny	[ˈt͡ʂarn̪ɨ]
Święty	[ˈɕfʲjɛ̃n̪t̪ɨ]
Dobry	/ˈd̪ɔbrɨ/
Głodny	[ˈɡwɔd̪n̪ɨ]
Czerwony	/t͡ʂɛrˈvɔn̪ɨ/
Zielony	/ʑɛˈlɔn̪ɨ/
Żółty	/ˈʐuwt̪ɨ/
Gorczyca	[ɡɔrˈt͡ʂɨt͡s̪a]
Niedźwiedź	[ˈɲed͡ʑvʲjet͡ɕ]
Potęga	[pɔˈt̪ɛ̃ŋɡa]
Ząb	[z̪ɔ̃mp]
Żołądź	[ˈʐ̠ɔwɔ̃ɲt͡ɕ]
Żołądek	[ʐɔˈwɔ̃n̪d̪ɛk]
Zajączek	[ˈz̪ajɔnt͡ʂɛk]
Chwast	[xfast]
Błąd	[bwɔ̃n̪t̪]
Hałas	/ˈxawas̪/
Chałas	/ˈxawas̪/
Trąd	[t̪rɔ̃n̪t̪]
Mąka	[ˈmɔ̃ŋka]
Dolny	[ˈdɔlnɨ]
Biedny	[ˈbʲjɛd̪n̪ɨ]
Lniany	[ˈlʲɲãn̪ɨ]
Kwaśny	/ˈkfaɕnɨ/
Gęba	[ˈɡɛ̃mba]
Gemba	[ˈɡɛ̃mba]
Makowiec	/maˈkɔvjɛt͡s̪/
Sałata	[s̪aˈwat̪a]
