a	a
aby	ˈa.bɨ
abyśmy	aˈbɨɕ.mɨ
ach	ax
aksamitne	ak.saˈmʲit.nɛ
aksamitnym	ak.saˈmʲit.nɨm
albo	ˈal.bɔ
ale	ˈa.lɛ
andersen	anˈdɛr.sɛn
ani	aˈɲ.i
aż	aʂ
ażeby	aˈʐɛ.bɨ
bajeczkę	baˈjɛt͡ʂ.kɛ
bajek	ˈba.jɛk
bardzo	ˈbar.d͡zɔ
bawiła	baˈvʲi.wa
bawiło	baˈvʲi.wɔ
bała	ˈba.wa
bez	bɛs
biały	ˈbʲa.wɨ
białymi	ˈbʲa.wɨˈmʲ.i
bicie	ˈbʲi.t͡ɕɛ
biedactwo	bʲɛˈdat͡s.tfɔ
biedna	ˈbʲɛd.na
biedne	ˈbʲɛd.nɛ
biedną	ˈbʲɛd.nɔ̃
biegały	bʲɛˈɡa.wɨ
bieliznę	bʲɛˈlʲiz.nɛ
blady	ˈbla.dɨ
blasku	ˈbla.sku
bo	bɔ
bogacz	ˈbɔ.ɡat͡ʂ
bogatej	bɔˈɡa.tɛj
bogaty	bɔˈɡa.tɨ
bogu	ˈbɔ.ɡu
bok	bɔk
boków	ˈbɔ.kuf
boży	ˈbɔ.ʐɨ
bożym	ˈbɔ.ʐɨm
breke-ke-keks	brɛ.kɛˈkɛ.kɛks
brekekeks	brɛˈkɛ.kɛks
brzegu	ˈbʐɛ.ɡu
brzydka	ˈbʐɨt.ka
brzydkiego	bʐɨtˈkʲɛ.ɡɔ
brzydkiej	ˈbʐɨt.kʲɛj
brzydszy	ˈbʐɨt.ʂɨ
buja	ˈbu.ja
by	bɨ
byli	bɨˈlʲ.i
bym	bɨm
byt	bɨt
być	bɨt͡ɕ
był	bɨw
była	ˈbɨ.wa
było	ˈbɨ.wɔ
byłoby	bɨˈwɔ.bɨ
były	ˈbɨ.wɨ
bój	buj
będzie	ˈbɛɲ.d͡ʑɛ
będziemy	bɛɲˈd͡ʑɛ.mɨ
będziesz	ˈbɛɲ.d͡ʑɛʂ
bądź	bɔɲt͡ɕ
będę	ˈbɛn.dɛ
błocie	ˈbwɔ.t͡ɕɛ
błota	ˈbwɔ.ta
błyszczała	bwɨʂˈt͡ʂa.wa
błyszczącym	bwɨʂˈt͡ʂɔn.t͡sɨm
błękitne	bwɛŋˈkʲit.nɛ
błękitnym	bwɛŋˈkʲit.nɨm
błękitu	bwɛŋˈkʲi.tu
calineczce	t͡sa.lʲiˈnɛt͡ʂ.t͡sɛ
calineczka	t͡sa.lʲiˈnɛt͡ʂ.ka
calineczki	t͡saˈlʲi.nɛt͡ʂˈkʲ.i
calineczko	t͡sa.lʲiˈnɛt͡ʂ.kɔ
calineczką	t͡sa.lʲiˈnɛt͡ʂ.kɔ̃
calineczkę	t͡sa.lʲiˈnɛt͡ʂ.kɛ
całe	ˈt͡sa.wɛ
całowała	t͡sa.wɔˈva.wa
cały	ˈt͡sa.wɨ
całą	ˈt͡sa.wɔ̃
chce	xt͡sɛ
chciał	xt͡ɕaw
chciała	ˈxt͡ɕa.wa
chociaż	ˈxɔ.t͡ɕaʂ
chodzi	xɔˈd͡ʑ.i
chodźże	ˈxɔd͡ʑ.ʐɛ
chrabąszcz	ˈxra.bɔŋʂt͡ʂ
chrabąszcza	xraˈbɔŋ.ʂt͡ʂa
chrabąszcze	xraˈbɔŋ.ʂt͡ʂɛ
chrabąszczowi	xraˈbɔŋ.ʂt͡ʂɔˈvʲ.i
chrabąszczu	xraˈbɔŋ.ʂt͡ʂu
chrabąszczówna	xra.bɔŋˈʂt͡ʂuv.na
chrapliwym	xrapˈlʲi.vɨm
christian	xrʲiˈsti.an
chwilach	ˈxfʲi.lax
chwili	xfʲiˈlʲ.i
chwilkę	ˈxfʲil.kɛ
chwilę	ˈxfʲi.lɛ
chyba	ˈxɨ.ba
chęcią	ˈxɛɲ.t͡ɕɔ̃
chłodna	ˈxwɔd.na
chłodu	ˈxwɔ.du
chłopcy	ˈxwɔp.t͡sɨ
chłopczyku	xwɔpˈt͡ʂɨ.ku
ci	ˈt͡ɕ.i
ciasno	ˈt͡ɕas.nɔ
ciałka	ˈt͡ɕaw.ka
ciało	ˈt͡ɕa.wɔ
cichutko	t͡ɕiˈxut.kɔ
ciekawe	t͡ɕɛˈka.vɛ
ciemnego	t͡ɕɛmˈnɛ.ɡɔ
ciemnym	ˈt͡ɕɛm.nɨm
ciemną	ˈt͡ɕɛm.nɔ̃
cieniutkim	t͡ɕɛˈɲut.kʲim
cienka	ˈt͡ɕɛn.ka
cieplej	ˈt͡ɕɛp.lɛj
cieplejszych	t͡ɕɛpˈlɛj.ʂɨx
ciepła	ˈt͡ɕɛ.pwa
ciepłe	ˈt͡ɕɛ.pwɛ
ciepłej	ˈt͡ɕɛ.pwɛj
ciepło	ˈt͡ɕɛ.pwɔ
ciepły	ˈt͡ɕɛ.pwɨ
ciepłych	ˈt͡ɕɛ.pwɨx
ciepłym	ˈt͡ɕɛ.pwɨm
cierpi	t͡ɕɛrˈpʲ.i
cierń	t͡ɕɛrɲ
cieszyła	t͡ɕɛˈʂɨ.wa
cień	t͡ɕɛɲ
cię	t͡ɕɛ
ciągle	ˈt͡ɕɔŋ.ɡlɛ
ciężkie	ˈt͡ɕɛŋ.ʂkʲɛ
co	t͡sɔ
codziennie	t͡sɔˈd͡ʑɛn.ɲɛ
coś	t͡sɔɕ
cuda	ˈt͡su.da
cudne	ˈt͡sud.nɛ
cytryn	ˈt͡sɨ.trɨn
czarnym	ˈt͡ʂar.nɨm
czarownica	t͡ʂa.rɔvˈɲi.t͡sa
czarownicy	t͡ʂa.rɔvˈɲi.t͡sɨ
czas	t͡ʂas
czerwone	t͡ʂɛrˈvɔ.nɛ
czerwony	t͡ʂɛrˈvɔ.nɨ
cztery	ˈt͡ʂtɛ.rɨ
czuł	t͡ʂuw
czy	t͡ʂɨ
czystość	ˈt͡ʂɨ.stɔɕt͡ɕ
człowieka	t͡ʂwɔˈvʲɛ.ka
cóż	t͡suʂ
dachem	ˈda.xɛm
dalej	ˈda.lɛj
daleko	daˈlɛ.kɔ
daleką	daˈlɛ.kɔ̃
damom	ˈda.mɔm
damy	ˈda.mɨ
danii	daˈɲi.i
dary	ˈda.rɨ
dawna	ˈdav.na
deszczu	ˈdɛʂ.t͡ʂu
dla	dla
dni	tˈɲ.i
dnia	dɲa
dnie	dɲɛ
dniem	dɲɛm
do	dɔ
dobra	ˈdɔ.bra
dobre	ˈdɔ.brɛ
dobremu	dɔˈbrɛ.mu
dobry	ˈdɔ.brɨ
dobrze	ˈdɔb.ʐɛ
dochodzi	ˈdɔ.xɔˈd͡ʑ.i
dogonić	dɔˈɡɔ.ɲit͡ɕ
dokoła	dɔˈkɔ.wa
doleciały	dɔ.lɛˈt͡ɕa.wɨ
dom	dɔm
domu	ˈdɔ.mu
doniczce	dɔˈɲit͡ʂ.t͡sɛ
dookoła	dɔ.ʔɔˈkɔ.wa
dopiero	dɔˈpʲɛ.rɔ
dorzuciła	dɔ.ʐuˈt͡ɕi.wa
doskonale	dɔ.skɔˈna.lɛ
dostanie	dɔˈsta.ɲɛ
dostać	ˈdɔ.stat͡ɕ
dostał	ˈdɔ.staw
dostałam	dɔˈsta.wam
doszli	dɔʂˈlʲ.i
doszła	ˈdɔ.ʂwa
dotąd	ˈdɔ.tɔnt
drobna	ˈdrɔb.na
drodze	ˈdrɔ.d͡zɛ
droga	ˈdrɔ.ɡa
drogę	ˈdrɔ.ɡɛ
druga	ˈdru.ɡa
drugiego	druˈɡʲɛ.ɡɔ
drzewa	ˈdʐɛ.va
drzewami	ˈdʐɛ.vaˈmʲ.i
drzewo	ˈdʐɛ.vɔ
drzwiach	dʐvʲax
drżała	ˈdrʐa.wa
drżąc	drʐɔnt͡s
duch	dux
ducha	ˈdu.xa
duchy	ˈdu.xɨ
duszy	ˈdu.ʂɨ
duże	ˈdu.ʐɛ
dużym	ˈdu.ʐɨm
dwa	dva
dwadzieścia	dvaˈd͡ʑɛɕ.t͡ɕa
dwie	dvʲɛ
dwóch	dvux
dywanik	dɨˈva.ɲik
dzieci	d͡ʑɛˈt͡ɕ.i
dziecina	d͡ʑɛˈt͡ɕi.na
dziecinę	d͡ʑɛˈt͡ɕi.nɛ
dziecię	ˈd͡ʑɛ.t͡ɕɛ
dzieciątka	d͡ʑɛˈt͡ɕɔn.tka
dziecka	ˈd͡ʑɛt͡s.ka
dziecko	ˈd͡ʑɛt͡s.kɔ
dziesięć	ˈd͡ʑɛ.ɕɛɲt͡ɕ
dziewczynce	d͡ʑɛfˈt͡ʂɨn.t͡sɛ
dziewczynka	d͡ʑɛfˈt͡ʂɨn.ka
dziewczynki	ˈd͡ʑɛf.t͡ʂɨnˈkʲ.i
dziewczynkę	d͡ʑɛfˈt͡ʂɨn.kɛ
dziewczyny	d͡ʑɛfˈt͡ʂɨ.nɨ
dzieweczki	ˈd͡ʑɛ.vɛt͡ʂˈkʲ.i
dzień	d͡ʑɛɲ
dziobem	ˈd͡ʑɔ.bɛm
dzisiaj	ˈd͡ʑi.ɕaj
dziwnie	ˈd͡ʑiv.ɲɛ
dzięki	d͡ʑɛˈkʲ.i
dziękuj	ˈd͡ʑɛŋ.kuj
dziękuję	d͡ʑɛŋˈku.jɛ
dłonie	ˈdwɔ.ɲɛ
długa	ˈdwu.ɡa
długiej	ˈdwu.ɡʲɛj
długo	ˈdwu.ɡɔ
elf	ɛlf
elfy	ˈɛ.lfɨ
elfów	ˈɛ.lfuf
fe	fɛ
fiołkowe	fʲɔwˈkɔ.vɛ
fujarce	fuˈjar.t͡sɛ
futro	ˈfu.trɔ
futrze	ˈfut.ʂɛ
gaju	ˈɡa.ju
ganić	ˈɡa.ɲit͡ɕ
gałązkach	ɡaˈwɔ̃.skax
gdy	ɡdɨ
gdyby	ˈɡdɨ.bɨ
gdybym	ˈɡdɨ.bɨm
gdyż	ɡdɨʂ
gdzie	ɡd͡ʑɛ
gdzieś	ɡd͡ʑɛɕ
gniazda	ˈɡɲaz.da
gniazdeczku	ɡɲazˈdɛt͡ʂ.ku
gniazdka	ˈɡɲa.stka
gniazdo	ˈɡɲaz.dɔ
go	ɡɔ
godzien	ˈɡɔ.d͡ʑɛn
goniąc	ˈɡɔ.ɲɔnt͡s
goręcej	ɡɔˈrɛn.t͡sɛj
gospodarz	ɡɔˈspɔ.daʂ
gospodyni	ɡɔˈspɔ.dɨˈɲ.i
gotowa	ɡɔˈtɔ.va
gości	ɡɔɕˈt͡ɕ.i
gościnnej	ɡɔɕˈt͡ɕin.nɛj
granatowe	ɡra.naˈtɔ.vɛ
grał	ɡraw
groszy	ˈɡrɔ.ʂɨ
grube	ˈɡru.bɛ
grubszy	ˈɡrup.ʂɨ
grudki	ɡrutˈkʲ.i
grymasy	ɡrɨˈma.sɨ
grzbiecie	ˈɡʐbʲɛ.t͡ɕɛ
gustu	ˈɡu.stu
góry	ˈɡu.rɨ
górze	ˈɡu.ʐɛ
górę	ˈɡu.rɛ
głodu	ˈɡwɔ.du
głosem	ˈɡwɔ.sɛm
głosikiem	ɡwɔˈɕi.kʲɛm
głosu	ˈɡwɔ.su
głowy	ˈɡwɔ.vɨ
głośno	ˈɡwɔɕ.nɔ
gęste	ˈɡɛ̃.stɛ
gęstego	ɡɛ̃ˈstɛ.ɡɔ
gęstym	ˈɡɛ̃.stɨm
głupota	ɡwuˈpɔ.ta
głód	ɡwut
główki	ɡwufˈkʲ.i
główką	ˈɡwuf.kɔ̃
główkę	ˈɡwuf.kɛ
głębi	ɡwɛˈbʲ.i
głęboka	ɡwɛmˈbɔ.ka
głęboko	ɡwɛmˈbɔ.kɔ
hans	xans
het	xɛt
historie	xʲiˈstɔ.rʲɛ
historię	xʲiˈstɔ.rʲɛ
hm	xm
ho	xɔ
i	i
ile	ˈi.lɛ
im	im
imię	ˈi.mʲɛ
inaczej	iˈna.t͡ʂɛj
inne	ˈin.nɛ
innego	inˈnɛ.ɡɔ
innej	ˈin.nɛj
innych	ˈin.nɨx
innymi	ˈin.nɨˈmʲ.i
iskierki	ˈis.kʲɛrˈkʲ.i
izba	ˈiz.ba
izby	ˈiz.bɨ
iż	iʂ
ja	ja
jadła	ˈja.dwa
jak	jak
jaka	ˈja.ka
jakaż	ˈja.kaʂ
jakby	ˈjak.bɨ
jaki	jaˈkʲ.i
jakich	ˈja.kʲix
jakiego	jaˈkʲɛ.ɡɔ
jakim	ˈja.kʲim
jakiś	ˈja.kʲiɕ
jakże	ˈjak.ʂɛ
jamkę	ˈjam.kɛ
jaskółce	jaˈskuw.t͡sɛ
jaskółek	jaˈsku.wɛk
jaskółka	jaˈskuw.ka
jaskółki	ˈja.skuwˈkʲ.i
jaskółką	jaˈskuw.kɔ̃
jaskółkę	jaˈskuw.kɛ
jasne	ˈjas.nɛ
jasnego	jasˈnɛ.ɡɔ
jasno	ˈjas.nɔ
jaśniej	ˈjaɕ.ɲɛj
je	jɛ
jeden	ˈjɛ.dɛn
jedna	ˈjɛd.na
jednak	ˈjɛd.nak
jednego	jɛdˈnɛ.ɡɔ
jednej	ˈjɛd.nɛj
jednym	ˈjɛd.nɨm
jego	ˈjɛ.ɡɔ
jej	jɛj
jesieni	ˈjɛ.ɕɛˈɲ.i
jesień	ˈjɛ.ɕɛɲ
jest	jɛst
jestem	ˈjɛ.stɛm
jesteś	ˈjɛ.stɛɕ
jeszcze	ˈjɛʂ.t͡ʂɛ
jeziorem	jɛˈʑɔ.rɛm
jeśli	jɛɕˈlʲ.i
już	juʂ
ją	jɔ̃
jęczmienia	jɛnˈt͡ʂmʲɛ.ɲa
jędzy	ˈjɛn.d͡zɨ
kamień	ˈka.mʲɛɲ
kawałek	kaˈva.wɛk
kawałkiem	kaˈvaw.kʲɛm
każdego	kaʐˈdɛ.ɡɔ
każdy	ˈkaʐ.dɨ
kiedy	ˈkʲɛ.dɨ
kielicha	kʲɛˈlʲi.xa
kilka	ˈkʲil.ka
kiwit	ˈkʲi.vʲit
klasnęła	klasˈnɛ̃.wa
klombach	ˈklɔm.bax
koak	ˈkɔ.ak
kobieta	kɔˈbʲɛ.ta
kochana	kɔˈxa.na
kochane	kɔˈxa.nɛ
kok	kɔk
kolebkę	kɔˈlɛp.kɛ
kolumny	kɔˈlum.nɨ
koniczyny	kɔ.ɲiˈt͡ʂɨ.nɨ
koniec	ˈkɔ.ɲɛt͡s
koronie	kɔˈrɔ.ɲɛ
koronę	kɔˈrɔ.nɛ
korytarz	kɔˈrɨ.taʂ
kosztowało	kɔʂ.tɔˈva.wɔ
kołderkę	kɔwˈdɛr.kɛ
koło	ˈkɔ.wɔ
kożuszka	kɔˈʐuʂ.ka
kołysce	kɔˈwɨs.t͡sɛ
kołyseczkę	kɔ.wɨˈsɛt͡ʂ.kɛ
kołyską	kɔˈwɨ.skɔ̃
kraju	ˈkra.ju
krajów	ˈkra.juf
kret	krɛt
kreta	ˈkrɛ.ta
kretem	ˈkrɛ.tɛm
kroków	ˈkrɔ.kuf
kryształu	krɨʂˈta.wu
kryły	ˈkrɨ.wɨ
król	krul
królem	ˈkru.lɛm
królowa	kruˈlɔ.va
królowej	kruˈlɔ.vɛj
królową	kruˈlɔ.vɔ̃
krótkie	ˈkrut.kʲɛ
krążyła	krɔŋˈʐɨ.wa
kto	ktɔ
która	ˈktu.ra
które	ˈktu.rɛ
którego	ktuˈrɛ.ɡɔ
której	ˈktu.rɛj
który	ˈktu.rɨ
których	ˈktu.rɨx
którym	ˈktu.rɨm
którzy	ˈktu.ʐɨ
ku	ku
kuchnia	ˈkux.ɲa
kurom	ˈku.rɔm
kwiat	kfʲat
kwiatach	ˈkfʲa.tax
kwiatek	ˈkfʲa.tɛk
kwiatka	ˈkfʲat.ka
kwiatku	ˈkfʲat.ku
kwiatowe	kfʲaˈtɔ.vɛ
kwiatowy	kfʲaˈtɔ.vɨ
kwiatu	ˈkfʲa.tu
kwiatuszek	kfʲaˈtu.ʂɛk
kwiaty	ˈkfʲa.tɨ
kwiatów	ˈkfʲa.tuf
kwitną	ˈkfʲit.nɔ̃
kłosy	ˈkwɔ.sɨ
las	las
lasach	ˈla.sax
lasami	ˈla.saˈmʲ.i
lasu	ˈla.su
lasy	ˈla.sɨ
latarki	ˈla.tarˈkʲ.i
latać	ˈla.tat͡ɕ
latem	ˈla.tɛm
lato	ˈla.tɔ
leciała	lɛˈt͡ɕa.wa
lecie	ˈlɛ.t͡ɕɛ
lecieć	ˈlɛ.t͡ɕɛt͡ɕ
leciuchne	lɛˈt͡ɕux.nɛ
lecz	lɛt͡ʂ
lekka	ˈlɛk.ka
lekkie	ˈlɛk.kʲɛ
lepiej	ˈlɛ.pʲɛj
lesie	ˈlɛ.ɕɛ
leć	lɛt͡ɕ
leżał	ˈlɛ.ʐaw
leżałam	lɛˈʐa.wam
leżało	lɛˈʐa.wɔ
leży	ˈlɛ.ʐɨ
leżącą	lɛˈʐɔn.t͡sɔ̃
lilii	lʲiˈlʲi.i
listeczka	lʲiˈstɛt͡ʂ.ka
listeczku	lʲiˈstɛt͡ʂ.ku
listek	ˈlʲi.stɛk
listka	ˈlʲi.stka
listkami	ˈlʲi.stkaˈmʲ.i
listkiem	ˈlʲi.stkʲɛm
listku	ˈlʲi.stku
litościwej	lʲi.tɔɕˈt͡ɕi.vɛj
litościwie	lʲi.tɔɕˈt͡ɕi.vʲɛ
liści	lʲiɕˈt͡ɕ.i
liściach	ˈlʲiɕ.t͡ɕax
liście	ˈlʲiɕ.t͡ɕɛ
liściem	ˈlʲiɕ.t͡ɕɛm
liściu	ˈlʲiɕ.t͡ɕu
liść	lʲiɕt͡ɕ
lochu	ˈlɔ.xu
los	lɔs
losem	ˈlɔ.sɛm
lub	lup
lubi	luˈbʲ.i
lubili	ˈlu.bʲiˈlʲ.i
lubię	ˈlu.bʲɛ
lubił	ˈlu.bʲiw
lubiła	luˈbʲi.wa
ludzie	ˈlu.d͡ʑɛ
ma	ma
maja	ˈma.ja
mają	ˈma.jɔ̃
maleńka	maˈlɛɲ.ka
maleńki	ˈma.lɛɲˈkʲ.i
maleńkie	maˈlɛɲ.kʲɛ
maleńkiej	maˈlɛɲ.kʲɛj
maleństwa	maˈlɛɲ.stfa
maluchna	maˈlux.na
malusieńka	ma.luˈɕɛɲ.ka
malutkie	maˈlut.kʲɛ
marmurowy	mar.muˈrɔ.vɨ
martwego	marˈtfɛ.ɡɔ
martwy	ˈmar.tfɨ
marznie	ˈmaʐ.ɲɛ
masz	maʂ
matka	ˈmat.ka
matki	matˈkʲ.i
mała	ˈma.wa
małe	ˈma.wɛ
małego	maˈwɛ.ɡɔ
mały	ˈma.wɨ
małą	ˈma.wɔ̃
mi	ˈmʲ.i
miasta	ˈmʲa.sta
miał	mʲaw
miała	ˈmʲa.wa
miejsca	ˈmʲɛj.st͡sa
miejscu	ˈmʲɛj.st͡su
mieli	mʲɛˈlʲ.i
mieszkające	mʲɛʂ.kaˈjɔn.t͡sɛ
mieszkali	ˈmʲɛʂ.kaˈlʲ.i
mieszkania	mʲɛʂˈka.ɲa
mieszkanie	mʲɛʂˈka.ɲɛ
mieszkaniu	mʲɛʂˈka.ɲu
mieszkać	ˈmʲɛʂ.kat͡ɕ
mieszkał	ˈmʲɛʂ.kaw
mieszkała	mʲɛʂˈka.wa
mieć	mʲɛt͡ɕ
mieści	mʲɛɕˈt͡ɕ.i
mijała	mʲiˈja.wa
miodu	ˈmʲɔ.du
między	ˈmʲɛn.d͡zɨ
miłe	ˈmʲi.wɛ
miłej	ˈmʲi.wɛj
miękkich	ˈmʲɛŋ.kkʲix
miętowym	mʲɛnˈtɔ.vɨm
mnie	mɲɛ
mną	mnɔ̃
mocniejszych	mɔt͡sˈɲɛj.ʂɨx
mogą	ˈmɔ.ɡɔ̃
mogę	ˈmɔ.ɡɛ
mogła	ˈmɔ.ɡwa
moich	ˈmɔ.ix
moim	ˈmɔ.im
moja	ˈmɔ.ja
mojego	mɔˈjɛ.ɡɔ
mokre	ˈmɔ.krɛ
morza	ˈmɔ.ʐa
morzami	ˈmɔ.ʐaˈmʲ.i
motyl	ˈmɔ.tɨl
motyla	mɔˈtɨ.la
motylami	mɔˈtɨ.laˈmʲ.i
mościa	ˈmɔɕ.t͡ɕa
może	ˈmɔ.ʐɛ
możesz	ˈmɔ.ʐɛʂ
można	ˈmɔʐ.na
mroźna	ˈmrɔʑ.na
mruknęła	mrukˈnɛ̃.wa
mróz	mrus
mu	mu
muchy	ˈmu.xɨ
musi	muˈɕ.i
musiał	ˈmu.ɕaw
musiała	muˈɕa.wa
musisz	ˈmu.ɕiʂ
mysz	mɨʂ
myszka	ˈmɨʂ.ka
myszy	ˈmɨ.ʂɨ
myszą	ˈmɨ.ʂɔ̃
myślał	ˈmɨɕ.law
myślała	mɨɕˈla.wa
myśleć	ˈmɨɕ.lɛt͡ɕ
mógł	muɡw
mój	muj
mów	muf
mówić	ˈmu.vʲit͡ɕ
młoda	ˈmwɔ.da
młode	ˈmwɔ.dɛ
młodej	ˈmwɔ.dɛj
młodą	ˈmwɔ.dɔ̃
mąż	mɔŋʂ
na	na
nabrała	naˈbra.wa
nad	nat
nadchodzi	ˈnat.xɔˈd͡ʑ.i
nadejdzie	naˈdɛj.d͡ʑɛ
nadeszła	naˈdɛ.ʂwa
nagie	ˈna.ɡʲɛ
najbardziej	najˈbar.d͡ʑɛj
najdalej	najˈda.lɛj
najlepiej	najˈlɛ.pʲɛj
najpiękniej	najˈpʲɛŋ.kɲɛj
najpiękniejsze	naj.pʲɛŋˈkɲɛj.ʂɛ
najpiękniejszego	naj.pʲɛŋ.kɲɛjˈʂɛ.ɡɔ
najpiękniejszych	naj.pʲɛŋˈkɲɛj.ʂɨx
najpiękniejszą	naj.pʲɛŋˈkɲɛj.ʂɔ̃
największy	najˈvʲɛŋ.kʂɨ
największą	najˈvʲɛŋ.kʂɔ̃
najęła	naˈjɛ̃.wa
nam	nam
napił	ˈna.pʲiw
naprawdę	naˈprav.dɛ
naprzód	ˈnap.ʂut
narzeczoną	na.ʐɛˈt͡ʂɔ.nɔ̃
narzekał	naˈʐɛ.kaw
nas	nas
nastąpił	naˈstɔm.pʲiw
następnej	naˈstɛm.pnɛj
naturalnie	na.tuˈral.ɲɛ
natychmiast	naˈtɨx.mʲast
nawet	ˈna.vɛt
nawzajem	navˈza.jɛm
nazwali	ˈnaz.vaˈlʲ.i
nazywali	naˈzɨ.vaˈlʲ.i
nazywała	na.zɨˈva.wa
niby	ˈɲi.bɨ
nic	ɲit͡s
nich	ɲix
nie	ɲɛ
niebo	ˈɲɛ.bɔ
niedawno	ɲɛˈdav.nɔ
niedobry	ɲɛˈdɔ.brɨ
niedługo	ɲɛˈdwu.ɡɔ
niegdyś	ˈɲɛɡ.dɨɕ
niej	ɲɛj
niektóre	ɲɛkˈtu.rɛ
niem	ɲɛm
niema	ˈɲɛ.ma
niepodobna	ɲɛ.pɔˈdɔb.na
nietrudno	ɲɛˈtrud.nɔ
niewiele	ɲɛˈvʲɛ.lɛ
niewygodnie	ɲɛ.vɨˈɡɔ.dɲɛ
niezgrabny	ɲɛzˈɡrab.nɨ
niezmiernie	ɲɛzˈmʲɛr.ɲɛ
niezmierny	ɲɛzˈmʲɛr.nɨ
nieznośną	ɲɛzˈnɔɕ.nɔ̃
niezwłocznie	ɲɛzˈvwɔt͡ʂ.ɲɛ
nieżywym	ɲɛˈʐɨ.vɨm
nigdy	ˈɲiɡ.dɨ
nikt	ɲikt
nim	ɲim
nimi	ɲiˈmʲ.i
nią	ɲɔ̃
niż	ɲiʂ
nocy	ˈnɔ.t͡sɨ
nocą	ˈnɔ.t͡sɔ̃
nogi	nɔˈɡʲ.i
nogą	ˈnɔ.ɡɔ̃
norce	ˈnɔr.t͡sɛ
norki	nɔrˈkʲ.i
norką	ˈnɔr.kɔ̃
norkę	ˈnɔr.kɛ
nos	nɔs
nowy	ˈnɔ.vɨ
nudnego	nudˈnɛ.ɡɔ
nudny	ˈnud.nɨ
nóżki	nuʂˈkʲ.i
nędza	ˈnɛn.d͡za
o	ɔ
obie	ˈɔ.bʲɛ
objęła	ɔbˈjɛ̃.wa
obronić	ɔˈbrɔ.ɲit͡ɕ
obszerna	ɔpˈʂɛr.na
obu	ˈɔ.bu
obudzisz	ɔˈbu.d͡ʑiʂ
ocalić	ɔˈt͡sa.lʲit͡ɕ
ocaliła	ɔ.t͡saˈlʲi.wa
och	ɔx
ochoty	ɔˈxɔ.tɨ
ochrony	ɔˈxrɔ.nɨ
oczach	ˈɔ.t͡ʂax
oczy	ˈɔ.t͡ʂɨ
od	ɔt
oddalać	ɔdˈda.lat͡ɕ
ode	ˈɔ.dɛ
odgarnęła	ɔd.ɡarˈnɛ̃.wa
odlatują	ɔ.dlaˈtu.jɔ̃
odleciał	ɔˈdlɛ.t͡ɕaw
odleciały	ɔ.dlɛˈt͡ɕa.wɨ
odlotu	ɔˈdlɔ.tu
odniósł	ˈɔ.dɲusw
odpowiednio	ɔt.pɔˈvʲɛ.dɲɔ
odpowiedziała	ɔt.pɔ.vʲɛˈd͡ʑa.wa
odprowadził	ɔt.prɔˈva.d͡ʑiw
odpłynęli	ɔtˈpwɨ.nɛˈlʲ.i
odrzuci	ˈɔd.ʐuˈt͡ɕ.i
odtąd	ˈɔt.tɔnt
odwagi	ˈɔd.vaˈɡʲ.i
odwiedza	ɔdˈvʲɛ.d͡za
odwiedzał	ɔdˈvʲɛ.d͡zaw
odwiedziny	ɔd.vʲɛˈd͡ʑi.nɨ
odwrócili	ɔdˈvru.t͡ɕiˈlʲ.i
odłamami	ɔˈdwa.maˈmʲ.i
ogarniał	ɔˈɡar.ɲaw
ogołocone	ɔ.ɡɔ.wɔˈt͡sɔ.nɛ
ogrodu	ɔˈɡrɔ.du
ogromne	ɔˈɡrɔm.nɛ
ogromny	ɔˈɡrɔm.nɨ
ogrzałam	ɔˈɡʐa.wam
oknem	ˈɔk.nɛm
okropnie	ɔˈkrɔp.ɲɛ
okropny	ɔˈkrɔp.nɨ
okryte	ɔˈkrɨ.tɛ
okrywa	ɔˈkrɨ.va
okryła	ɔˈkrɨ.wa
okrągłe	ɔˈkrɔŋ.ɡwɛ
on	ɔn
ona	ˈɔ.na
one	ˈɔ.nɛ
ono	ˈɔ.nɔ
opadł	ˈɔ.padw
opiekowała	ɔ.pʲɛ.kɔˈva.wa
opisać	ɔˈpʲi.sat͡ɕ
oplatało	ɔp.laˈta.wɔ
opowiadać	ɔ.pɔˈvʲa.dat͡ɕ
opowiedział	ɔ.pɔˈvʲɛ.d͡ʑaw
opowiedzieć	ɔ.pɔˈvʲɛ.d͡ʑɛt͡ɕ
oprócz	ˈɔ.prut͡ʂ
orzecha	ɔˈʐɛ.xa
ostatni	ˈɔ.statˈɲ.i
ostry	ˈɔ.strɨ
ostrymi	ˈɔ.strɨˈmʲ.i
ostrzegał	ɔˈstʂɛ.ɡaw
osłabiona	ɔ.swaˈbʲɔ.na
oto	ˈɔ.tɔ
otoczony	ɔ.tɔˈt͡ʂɔ.nɨ
otoczonym	ɔ.tɔˈt͡ʂɔ.nɨm
otuliła	ɔ.tuˈlʲi.wa
otworem	ɔˈtfɔ.rɛm
otworzył	ɔˈtfɔ.ʐɨw
otworzyła	ɔ.tfɔˈʐɨ.wa
otwór	ˈɔ.tfur
ożenić	ɔˈʐɛ.ɲit͡ɕ
ożenił	ɔˈʐɛ.ɲiw
oświadczył	ɔɕˈfʲat.t͡ʂɨw
oświecając	ɔɕ.fʲɛˈt͡sa.jɔnt͡s
oświetlił	ɔɕˈfʲɛt.lʲiw
ożyła	ɔˈʐɨ.wa
pada	ˈpa.da
padają	paˈda.jɔ̃
padać	ˈpa.dat͡ɕ
pająki	ˈpa.jɔ̃ˈkʲ.i
palące	paˈlɔn.t͡sɛ
pamiętał	paˈmʲɛn.taw
pan	pan
panią	ˈpa.ɲɔ̃
panno	ˈpan.nɔ
panny	ˈpan.nɨ
para	ˈpa.ra
parami	ˈpa.raˈmʲ.i
pary	ˈpa.rɨ
pasek	ˈpa.sɛk
pasie	ˈpa.ɕɛ
paskiem	ˈpas.kʲɛm
patrzała	patˈʂa.wa
patrzcie	ˈpat.ʂt͡ɕɛ
patrzeć	ˈpat.ʂɛt͡ɕ
pałac	ˈpa.wat͡s
pałacu	paˈwa.t͡su
pewna	ˈpɛv.na
pewnego	pɛvˈnɛ.ɡɔ
pełna	ˈpɛw.na
pełno	ˈpɛw.nɔ
pielęgnować	pʲɛ.lɛŋˈɡnɔ.vat͡ɕ
pieśń	pʲɛɕɲ
piosenki	ˈpʲɔ.sɛnˈkʲ.i
piosenkę	pʲɔˈsɛn.kɛ
piwnica	pʲivˈɲi.t͡sa
piórek	ˈpʲu.rɛk
piórka	ˈpʲur.ka
piórkami	ˈpʲur.kaˈmʲ.i
piła	ˈpʲi.wa
pięknego	pʲɛŋˈknɛ.ɡɔ
piękniej	ˈpʲɛŋ.kɲɛj
piękny	ˈpʲɛŋ.knɨ
pięknymi	ˈpʲɛŋ.knɨˈmʲ.i
piękną	ˈpʲɛŋ.knɔ̃
po	pɔ
pobiegła	pɔˈbʲɛ.ɡwa
pobliżu	pɔbˈlʲi.ʐu
pochowano	pɔ.xɔˈva.nɔ
pochyliła	pɔ.xɨˈlʲi.wa
poczciwa	pɔt͡ʂˈt͡ɕi.va
poczciwie	pɔt͡ʂˈt͡ɕi.vʲɛ
pocznie	ˈpɔt͡ʂ.ɲɛ
pod	pɔt
podarły	pɔˈda.rwɨ
podał	ˈpɔ.daw
podesłała	pɔ.dɛˈswa.wa
podfrunęła	pɔ.tfruˈnɛ̃.wa
podniosła	pɔˈdɲɔ.swa
podniósł	ˈpɔ.dɲusw
podoba	pɔˈdɔ.ba
podobała	pɔ.dɔˈba.wa
podobało	pɔ.dɔˈba.wɔ
podobna	pɔˈdɔb.na
podobnego	pɔ.dɔbˈnɛ.ɡɔ
podobny	pɔˈdɔb.nɨ
podróż	ˈpɔ.druʂ
podróży	pɔˈdru.ʐɨ
podwieczorek	pɔd.vʲɛˈt͡ʂɔ.rɛk
podzielę	pɔˈd͡ʑɛ.lɛ
podziemie	pɔˈd͡ʑɛ.mʲɛ
pogardliwie	pɔ.ɡarˈdlʲi.vʲɛ
pojedynczo	pɔ.jɛˈdɨn.t͡ʂɔ
pokarm	ˈpɔ.karm
pokazać	pɔˈka.zat͡ɕ
pokazała	pɔ.kaˈza.wa
pokochałby	pɔ.kɔˈxaw.bɨ
pokoju	pɔˈkɔ.ju
pola	ˈpɔ.la
pole	ˈpɔ.lɛ
polecę	pɔˈlɛ.t͡sɛ
polna	ˈpɔl.na
polnej	ˈpɔl.nɛj
polnym	ˈpɔl.nɨm
polną	ˈpɔl.nɔ̃
polu	ˈpɔ.lu
polubiła	pɔ.luˈbʲi.wa
pomarańcz	pɔˈma.raɲt͡ʂ
pomiędzy	pɔˈmʲɛn.d͡zɨ
pomyślała	pɔ.mɨɕˈla.wa
ponad	ˈpɔ.nat
poprosiła	pɔ.prɔˈɕi.wa
popłynął	pɔˈpwɨ.nɔ̃w
popłynęła	pɔ.pwɨˈnɛ̃.wa
poradzi	ˈpɔ.raˈd͡ʑ.i
poradzić	pɔˈra.d͡ʑit͡ɕ
porwał	ˈpɔr.vaw
porzuciła	pɔ.ʐuˈt͡ɕi.wa
porządek	pɔˈʐɔn.dɛk
porę	ˈpɔ.rɛ
posadził	pɔˈsa.d͡ʑiw
posadziła	pɔ.saˈd͡ʑi.wa
posiada	pɔˈɕa.da
postanowiły	pɔ.sta.nɔˈvʲi.wɨ
postawiła	pɔ.staˈvʲi.wa
poszła	ˈpɔ.ʂwa
posępne	pɔˈsɛm.pnɛ
posępną	pɔˈsɛm.pnɔ̃
posłużyły	pɔ.swuˈʐɨ.wɨ
potem	ˈpɔ.tɛm
potrzeby	pɔtˈʂɛ.bɨ
potwierdziła	pɔt.fʲɛrˈd͡ʑi.wa
potykając	pɔ.tɨˈka.jɔnt͡s
poważnie	pɔˈvaʐ.ɲɛ
powiedz	ˈpɔ.vʲɛt͡s
powiedział	pɔˈvʲɛ.d͡ʑaw
powiedziała	pɔ.vʲɛˈd͡ʑa.wa
powiedziały	pɔ.vʲɛˈd͡ʑa.wɨ
powiedzieć	pɔˈvʲɛ.d͡ʑɛt͡ɕ
powieki	ˈpɔ.vʲɛˈkʲ.i
powierzchni	ˈpɔ.vʲɛʂxˈɲ.i
powierzchnię	pɔˈvʲɛʂ.xɲɛ
powietrze	pɔˈvʲɛt.ʂɛ
powietrzu	pɔˈvʲɛt.ʂu
powiędły	pɔˈvʲɛn.dwɨ
powrocie	pɔˈvrɔ.t͡ɕɛ
powrotem	pɔˈvrɔ.tɛm
powrócą	pɔˈvru.t͡sɔ̃
powstał	ˈpɔf.staw
powtarzała	pɔf.taˈʐa.wa
pozbyć	ˈpɔz.bɨt͡ɕ
pozdrów	ˈpɔz.druf
pozwalała	pɔz.vaˈla.wa
pozwolił	pɔzˈvɔ.lʲiw
pożegnaj	pɔˈʐɛɡ.naj
pożegnać	pɔˈʐɛɡ.nat͡ɕ
pożegnała	pɔ.ʐɛɡˈna.wa
pożywienia	pɔ.ʐɨˈvʲɛ.ɲa
pragnęła	praɡˈnɛ̃.wa
prawdziwy	pravˈd͡ʑi.vɨ
prawie	ˈpra.vʲɛ
promienie	prɔˈmʲɛ.ɲɛ
promyk	ˈprɔ.mɨk
przechyliło	pʂɛ.xɨˈlʲi.wɔ
przecież	ˈpʂɛ.t͡ɕɛʂ
przed	pʂɛt
przeglądało	pʂɛɡ.lɔnˈda.wɔ
przegryzły	pʂɛˈɡrɨ.zwɨ
przejrzyste	pʂɛjˈʐɨ.stɛ
przejrzystymi	pʂɛjˈʐɨ.stɨˈmʲ.i
przekopał	pʂɛˈkɔ.paw
przelatywać	pʂɛ.laˈtɨ.vat͡ɕ
przelękła	pʂɛˈlɛŋ.kwa
przeminie	pʂɛˈmʲi.ɲɛ
przemknął	ˈpʂɛm.knɔ̃w
przemowę	pʂɛˈmɔ.vɛ
przemówił	pʂɛˈmu.vʲiw
przenieść	ˈpʂɛ.ɲɛɕt͡ɕ
przestraszona	pʂɛ.straˈʂɔ.na
przestraszył	pʂɛˈstra.ʂɨw
przestraszyła	pʂɛ.straˈʂɨ.wa
przestraszyły	pʂɛ.straˈʂɨ.wɨ
przesuwała	pʂɛ.suˈva.wa
przeszkody	pʂɛʂˈkɔ.dɨ
przez	pʂɛs
przezorny	pʂɛˈzɔr.nɨ
przezroczyste	pʂɛ.zrɔˈt͡ʂɨ.stɛ
przezroczystych	pʂɛ.zrɔˈt͡ʂɨ.stɨx
prześliczna	pʂɛɕˈlʲit͡ʂ.na
prześliczne	pʂɛɕˈlʲit͡ʂ.nɛ
prześlicznej	pʂɛɕˈlʲit͡ʂ.nɛj
prześlicznie	pʂɛɕˈlʲit͡ʂ.ɲɛ
prześliczny	pʂɛɕˈlʲit͡ʂ.nɨ
przeżyła	pʂɛˈʐɨ.wa
przy	pʂɨ
przychodzi	ˈpʂɨ.xɔˈd͡ʑ.i
przyglądały	pʂɨɡ.lɔnˈda.wɨ
przygotuję	pʂɨ.ɡɔˈtu.jɛ
przyjaźń	ˈpʂɨ.jaʑɲ
przyjdzie	ˈpʂɨj.d͡ʑɛ
przyjemnie	pʂɨˈjɛm.ɲɛ
przyjemności	pʂɨˈjɛm.nɔɕˈt͡ɕ.i
przyjrzeć	ˈpʂɨj.ʐɛt͡ɕ
przyjęła	pʂɨˈjɛ̃.wa
przykro	ˈpʂɨ.krɔ
przykryła	pʂɨˈkrɨ.wa
przyleciała	pʂɨ.lɛˈt͡ɕa.wa
przyniosła	pʂɨˈɲɔ.swa
przyniósł	ˈpʂɨ.ɲusw
przyozdobiła	pʂɨ.ɔz.dɔˈbʲi.wa
przyszedł	ˈpʂɨ.ʂɛdw
przyszło	ˈpʂɨ.ʂwɔ
przytuliła	pʂɨ.tuˈlʲi.wa
przytuliło	pʂɨ.tuˈlʲi.wɔ
przywiązano	pʂɨ.vʲɔ̃ˈza.nɔ
przywiązała	pʂɨ.vʲɔ̃ˈza.wa
przyznała	pʂɨzˈna.wa
przyświecało	pʂɨɕ.fʲɛˈt͡sa.wɔ
przędły	ˈpʂɛn.dwɨ
pręciki	ˈprɛɲ.t͡ɕiˈkʲ.i
prądem	ˈprɔn.dɛm
prędzej	ˈprɛn.d͡zɛj
pszczółka	ˈpʂt͡ʂuw.ka
ptak	ptak
ptaka	ˈpta.ka
ptaki	ptaˈkʲ.i
ptakiem	ˈpta.kʲɛm
ptakowi	ˈpta.kɔˈvʲ.i
ptaszek	ˈpta.ʂɛk
ptaszka	ˈptaʂ.ka
ptaszki	ptaʂˈkʲ.i
ptaszkowi	ˈptaʂ.kɔˈvʲ.i
ptaszku	ˈptaʂ.ku
ptaszków	ˈptaʂ.kuf
ptaszyna	ptaˈʂɨ.na
ptaszyny	ptaˈʂɨ.nɨ
ptaszynę	ptaˈʂɨ.nɛ
puszek	ˈpu.ʂɛk
pyszczek	ˈpɨʂ.t͡ʂɛk
pył	pɨw
płacz	pwat͡ʂ
płaczem	ˈpwa.t͡ʂɛm
płaczu	ˈpwa.t͡ʂu
płakać	ˈpwa.kat͡ɕ
płakała	pwaˈka.wa
płatek	ˈpwa.tɛk
płatki	pwatˈkʲ.i
płatkiem	ˈpwat.kʲɛm
pączek	ˈpɔn.t͡ʂɛk
pęk	pɛŋk
pękł	pɛŋkw
płotach	ˈpwɔ.tax
płynął	ˈpwɨ.nɔ̃w
pływała	pwɨˈva.wa
pływały	pwɨˈva.wɨ
radością	raˈdɔɕ.t͡ɕɔ̃
radzi	raˈd͡ʑ.i
radzę	ˈra.d͡zɛ
raju	ˈra.ju
ramion	ˈra.mʲɔn
rano	ˈra.nɔ
ratować	raˈtɔ.vat͡ɕ
raz	ras
razem	ˈra.zɛm
razu	ˈra.zu
razy	ˈra.zɨ
robić	ˈrɔ.bʲit͡ɕ
roku	ˈrɔ.ku
ropucha	rɔˈpu.xa
ropuchy	rɔˈpu.xɨ
rosną	ˈrɔs.nɔ̃
rosnący	rɔsˈnɔn.t͡sɨ
rosę	ˈrɔ.sɛ
rosło	ˈrɔ.swɔ
rosły	ˈrɔ.swɨ
rowach	ˈrɔ.vax
rozciągało	rɔs.t͡ɕɔŋˈɡa.wɔ
rozdzielił	rɔzˈd͡ʑɛ.lʲiw
rozgniewała	rɔz.ɡɲɛˈva.wa
rozległe	rɔzˈlɛ.ɡwɛ
rozległo	rɔzˈlɛ.ɡwɔ
rozpłakała	rɔ.spwaˈka.wa
rozstać	ˈrɔs.stat͡ɕ
rozsądne	rɔsˈsɔn.dnɛ
rozweseliły	rɔz.vɛ.sɛˈlʲi.wɨ
rożków	ˈrɔʂ.kuf
roślinami	rɔɕˈlʲi.naˈmʲ.i
roślinka	rɔɕˈlʲin.ka
rybki	rɨpˈkʲ.i
rzeki	ʐɛˈkʲ.i
rzekł	ʐɛkw
rzekła	ˈʐɛ.kwa
różanym	ruˈʐa.nɨm
róży	ˈru.ʐɨ
rączki	rɔnt͡ʂˈkʲ.i
rękę	ˈrɛŋ.kɛ
sadzał	ˈsa.d͡zaw
salony	saˈlɔ.nɨ
sama	ˈsa.ma
samej	ˈsa.mɛj
samym	ˈsa.mɨm
schodzić	ˈsxɔ.d͡ʑit͡ɕ
schowało	sxɔˈva.wɔ
serca	ˈsɛr.t͡sa
serdecznie	sɛrˈdɛt͡ʂ.ɲɛ
siana	ˈɕa.na
siebie	ˈɕɛ.bʲɛ
sieją	ˈɕɛ.jɔ̃
sienniczek	ɕɛnˈɲi.t͡ʂɛk
sieroty	ɕɛˈrɔ.tɨ
się	ɕɛ
sił	ɕiw
siły	ˈɕi.wɨ
sklepieniu	sklɛˈpʲɛ.ɲu
skostniał	ˈskɔ.stɲaw
skruszonej	skruˈʂɔ.nɛj
skruszył	ˈskru.ʂɨw
skryła	ˈskrɨ.wa
skrzydeł	ˈskʂɨ.dɛw
skrzydełka	skʂɨˈdɛw.ka
skrzydełko	skʂɨˈdɛw.kɔ
skrzydłach	ˈskʂɨ.dwax
skrzydłami	ˈskʂɨ.dwaˈmʲ.i
skurczyło	skurˈt͡ʂɨ.wɔ
skąd	skɔnt
smutnie	ˈsmut.ɲɛ
smutno	ˈsmut.nɔ
sobie	ˈsɔ.bʲɛ
sokiem	ˈsɔ.kʲɛm
spacerować	spa.t͡sɛˈrɔ.vat͡ɕ
spała	ˈspa.wa
spiżarnia	spʲiˈʐar.ɲa
spod	spɔt
spojrzała	spɔjˈʐa.wa
spokojnie	spɔˈkɔj.ɲɛ
sposobem	spɔˈsɔ.bɛm
spostrzegła	spɔˈstʂɛ.ɡwa
spostrzegłszy	spɔˈstʂɛ.ɡwʂɨ
sposób	ˈspɔ.sup
spotka	ˈspɔt.ka
spróchniałego	sprux.ɲaˈwɛ.ɡɔ
srebro	ˈsrɛ.brɔ
stanie	ˈsta.ɲɛ
stanowiło	sta.nɔˈvʲi.wɔ
stanowiły	sta.nɔˈvʲi.wɨ
stanęła	staˈnɛ̃.wa
stara	ˈsta.ra
starannie	staˈran.ɲɛ
stawała	staˈva.wa
stała	ˈsta.wa
stało	ˈsta.wɔ
stały	ˈsta.wɨ
stole	ˈstɔ.lɛ
strachu	ˈstra.xu
straszna	ˈstraʂ.na
strasznie	ˈstraʂ.ɲɛ
strony	ˈstrɔ.nɨ
stronę	ˈstrɔ.nɛ
strumienia	struˈmʲɛ.ɲa
strumieniem	struˈmʲɛ.ɲɛm
strumyka	struˈmɨ.ka
strój	struj
stworzenie	stfɔˈʐɛ.ɲɛ
stąd	stɔnt
suche	ˈsu.xɛ
suchy	ˈsu.xɨ
suchych	ˈsu.xɨx
suchym	ˈsu.xɨm
sukienki	ˈsu.kʲɛnˈkʲ.i
swe	sfɛ
swego	ˈsfɛ.ɡɔ
swobodnie	sfɔˈbɔ.dɲɛ
swoich	ˈsfɔ.ix
swoim	ˈsfɔ.im
swojego	sfɔˈjɛ.ɡɔ
swoją	ˈsfɔ.jɔ̃
swój	sfuj
swą	sfɔ̃
syn	sɨn
syna	ˈsɨ.na
synem	ˈsɨ.nɛm
synka	ˈsɨn.ka
synowej	sɨˈnɔ.vɛj
sypią	ˈsɨ.pʲɔ̃
szczęście	ˈʂt͡ʂɛɲ.ɕt͡ɕɛ
szczęściem	ˈʂt͡ʂɛɲ.ɕt͡ɕɛm
szczęśliwa	ʂt͡ʂɛɲˈɕlʲi.va
szczęśliwej	ʂt͡ʂɛɲˈɕlʲi.vɛj
szedł	ʂɛdw
szepnęła	ʂɛpˈnɛ̃.wa
szeptała	ʂɛpˈta.wa
szkaradna	ʂkaˈrad.na
szkaradne	ʂkaˈrad.nɛ
szkaradnego	ʂka.radˈnɛ.ɡɔ
szkaradny	ʂkaˈrad.nɨ
szkaradną	ʂkaˈrad.nɔ̃
sztywne	ˈʂtɨv.nɛ
szumiały	ʂuˈmʲa.wɨ
szybkę	ˈʂɨp.kɛ
słabsze	ˈswap.ʂɛ
słabym	ˈswa.bɨm
słomek	ˈswɔ.mɛk
słomy	ˈswɔ.mɨ
słoneczka	swɔˈnɛt͡ʂ.ka
słoneczny	swɔˈnɛt͡ʂ.nɨ
słonka	ˈswɔn.ka
słonko	ˈswɔn.kɔ
słowa	ˈswɔ.va
słowach	ˈswɔ.vax
słońca	ˈswɔɲ.t͡sa
słońce	ˈswɔɲ.t͡sɛ
sąsiad	ˈsɔɲ.ɕat
sąsiadowi	sɔɲˈɕa.dɔˈvʲ.i
sąsiedzi	ˈsɔɲ.ɕɛˈd͡ʑ.i
słuchać	ˈswu.xat͡ɕ
słuchałam	swuˈxa.wam
słupek	ˈswu.pɛk
służył	ˈswu.ʐɨw
słyszał	ˈswɨ.ʂaw
słyszały	swɨˈʂa.wɨ
taczka	ˈtat͡ʂ.ka
tak	tak
taka	ˈta.ka
taki	taˈkʲ.i
takie	ˈta.kʲɛ
takiego	taˈkʲɛ.ɡɔ
takiej	ˈta.kʲɛj
takim	ˈta.kʲim
taką	ˈta.kɔ̃
także	ˈtak.ʂɛ
talerz	ˈta.lɛʂ
talerzu	taˈlɛ.ʐu
tam	tam
tamci	tamˈt͡ɕ.i
te	tɛ
tego	ˈtɛ.ɡɔ
tej	tɛj
tem	tɛm
temu	ˈtɛ.mu
ten	tɛn
teraz	ˈtɛ.ras
też	tɛʂ
to	tɔ
tobą	ˈtɔ.bɔ̃
toteż	ˈtɔ.tɛʂ
trawie	ˈtra.vʲɛ
trawy	ˈtra.vɨ
troskliwie	trɔˈsklʲi.vʲɛ
troszczył	ˈtrɔʂ.t͡ʂɨw
troszczyła	trɔʂˈt͡ʂɨ.wa
trudem	ˈtru.dɛm
trzciną	ˈtʂt͡ɕi.nɔ̃
trzeba	ˈtʂɛ.ba
trzymał	ˈtʂɨ.maw
trącając	trɔnˈt͡sa.jɔnt͡s
tu	tu
tulipana	tu.lʲiˈpa.na
tutaj	ˈtu.taj
tuż	tuʂ
twardej	ˈtfar.dɛj
twoją	ˈtfɔ.jɔ̃
tych	tɨx
tydzień	ˈtɨ.d͡ʑɛɲ
tygodnie	tɨˈɡɔ.dɲɛ
tyle	ˈtɨ.lɛ
tylko	ˈtɨl.kɔ
tym	tɨm
tymczasem	tɨmˈt͡ʂa.sɛm
tyś	tɨɕ
tę	tɛ
tęskniła	tɛ̃ˈskɲi.wa
tęsknotą	tɛ̃ˈsknɔ.tɔ̃
u	u
ubogiej	uˈbɔ.ɡʲɛj
ubranie	uˈbra.ɲɛ
ucałowała	u.t͡sa.wɔˈva.wa
uciec	ˈu.t͡ɕɛt͡s
uciekniemy	u.t͡ɕɛkˈɲɛ.mɨ
ucieszył	uˈt͡ɕɛ.ʂɨw
ucieszyła	u.t͡ɕɛˈʂɨ.wa
uczepiła	u.t͡ʂɛˈpʲi.wa
uczony	uˈt͡ʂɔ.nɨ
uczuła	uˈt͡ʂu.wa
uczynek	uˈt͡ʂɨ.nɛk
ujrzawszy	ujˈʐaf.ʂɨ
ujrzał	ˈuj.ʐaw
ujrzała	ujˈʐa.wa
ukrywać	uˈkrɨ.vat͡ɕ
ukłoniła	u.kwɔˈɲi.wa
ukąszę	uˈkɔŋ.ʂɛ
umiał	ˈu.mʲaw
umiała	uˈmʲa.wa
umiera	uˈmʲɛ.ra
umierają	u.mʲɛˈra.jɔ̃
umieściła	u.mʲɛɕˈt͡ɕi.wa
umrze	ˈum.ʐɛ
umrzeć	ˈum.ʐɛt͡ɕ
uniósł	ˈu.ɲusw
upadł	ˈu.padw
uplotła	upˈlɔ.twa
uprzejmie	upˈʂɛj.mʲɛ
upór	ˈu.pur
upłynęło	u.pwɨˈnɛ̃.wɔ
urodzić	uˈrɔ.d͡ʑit͡ɕ
urwie	ˈur.vʲɛ
urządzamy	u.ʐɔnˈd͡za.mɨ
urządzała	u.ʐɔnˈd͡za.wa
urządzić	uˈʐɔɲ.d͡ʑit͡ɕ
urządzone	u.ʐɔnˈd͡zɔ.nɛ
usiadł	ˈu.ɕadw
usiadła	uˈɕa.dwa
usiądziesz	uˈɕɔɲ.d͡ʑɛʂ
usiądź	ˈu.ɕɔɲt͡ɕ
utrzymywać	ut.ʂɨˈmɨ.vat͡ɕ
uwierzył	uˈvʲɛ.ʐɨw
uśmiechała	uɕ.mʲɛˈxa.wa
w	f
wam	vam
warta	ˈvar.ta
warto	ˈvar.tɔ
wartości	ˈvar.tɔɕˈt͡ɕ.i
was	vas
wata	ˈva.ta
wcale	ˈft͡sa.lɛ
wciąż	ft͡ɕɔŋʂ
we	vɛ
wejść	vɛjɕt͡ɕ
wesela	vɛˈsɛ.la
wesele	vɛˈsɛ.lɛ
weselną	vɛˈsɛl.nɔ̃
wesołe	vɛˈsɔ.wɛ
wesołego	vɛ.sɔˈwɛ.ɡɔ
wesołej	vɛˈsɔ.wɛj
wesoło	vɛˈsɔ.wɔ
weszła	ˈvɛ.ʂwa
wewnątrz	ˈvɛv.nɔntʂ
wiankiem	ˈvʲan.kʲɛm
widać	ˈvʲi.dat͡ɕ
widocznie	vʲiˈdɔt͡ʂ.ɲɛ
widok	ˈvʲi.dɔk
widzi	vʲiˈd͡ʑ.i
widział	ˈvʲi.d͡ʑaw
widziała	vʲiˈd͡ʑa.wa
widzieć	ˈvʲi.d͡ʑɛt͡ɕ
wiecznym	ˈvʲɛt͡ʂ.nɨm
wieczora	vʲɛˈt͡ʂɔ.ra
wieczorem	vʲɛˈt͡ʂɔ.rɛm
wiedział	ˈvʲɛ.d͡ʑaw
wiedziała	vʲɛˈd͡ʑa.wa
wielki	vʲɛlˈkʲ.i
wielkie	ˈvʲɛl.kʲɛ
wielkiego	vʲɛlˈkʲɛ.ɡɔ
wielkiej	ˈvʲɛl.kʲɛj
wielkim	ˈvʲɛl.kʲim
wietrzyk	ˈvʲɛt.ʂɨk
wino	ˈvʲi.nɔ
winogrona	vʲi.nɔˈɡrɔ.na
winszuję	vʲinˈʂu.jɛ
wiosna	ˈvʲɔs.na
wiosła	ˈvʲɔ.swa
więc	vʲɛnt͡s
więcej	ˈvʲɛn.t͡sɛj
większe	ˈvʲɛŋ.kʂɛ
wkoło	ˈfkɔ.wɔ
wkrótce	ˈfkrut.t͡sɛ
woda	ˈvɔ.da
wodnej	ˈvɔd.nɛj
wodnych	ˈvɔd.nɨx
wodnymi	ˈvɔd.nɨˈmʲ.i
wody	ˈvɔ.dɨ
wodzie	ˈvɔ.d͡ʑɛ
wodą	ˈvɔ.dɔ̃
wokoło	vɔˈkɔ.wɔ
woli	vɔˈlʲ.i
wolnych	ˈvɔl.nɨx
wpadł	fpadw
wpływem	ˈfpwɨ.vɛm
wraz	vras
wreszcie	ˈvrɛʂ.t͡ɕɛ
wrzeciona	vʐɛˈt͡ɕɔ.na
wróciła	vruˈt͡ɕi.wa
wschodzie	ˈfsxɔ.d͡ʑɛ
wsie	fɕɛ
wskoczyła	fskɔˈt͡ʂɨ.wa
wspaniałe	fspaˈɲa.wɛ
wspaniały	fspaˈɲa.wɨ
wspaniałych	fspaˈɲa.wɨx
wszelkie	ˈfʂɛl.kʲɛ
wszyscy	ˈfʂɨs.t͡sɨ
wszystkich	ˈfʂɨ.stkʲix
wszystkie	ˈfʂɨ.stkʲɛ
wszystkim	ˈfʂɨ.stkʲim
wszystko	ˈfʂɨ.stkɔ
wtedy	ˈftɛ.dɨ
wtem	ftɛm
wybierając	vɨ.bʲɛˈra.jɔnt͡s
wybieram	vɨˈbʲɛ.ram
wybierz	ˈvɨ.bʲɛʂ
wybij	ˈvɨ.bʲij
wybitą	vɨˈbʲi.tɔ̃
wybornie	vɨˈbɔr.ɲɛ
wybrała	vɨˈbra.wa
wychyliły	vɨ.xɨˈlʲi.wɨ
wyciągnęła	vɨ.t͡ɕɔŋˈɡnɛ̃.wa
wydała	vɨˈda.wa
wyfruwały	vɨ.fruˈva.wɨ
wyglądało	vɨɡ.lɔnˈda.wɔ
wyglądały	vɨɡ.lɔnˈda.wɨ
wygodne	vɨˈɡɔd.nɛ
wygodnie	vɨˈɡɔ.dɲɛ
wygodniej	vɨˈɡɔ.dɲɛj
wygodnym	vɨˈɡɔd.nɨm
wylecę	vɨˈlɛ.t͡sɛ
wymknęła	vɨmˈknɛ̃.wa
wypada	vɨˈpa.da
wypocząć	vɨˈpɔ.t͡ʂɔɲt͡ɕ
wyprawa	vɨˈpra.va
wyprawią	vɨˈpra.vʲɔ̃
wyprawą	vɨˈpra.vɔ̃
wyrzekła	vɨˈʐɛ.kwa
wyrósł	ˈvɨ.rusw
wyskoczyła	vɨ.skɔˈt͡ʂɨ.wa
wysokie	vɨˈsɔ.kʲɛ
wysoko	vɨˈsɔ.kɔ
wyspie	ˈvɨs.pʲɛ
wysunęła	vɨ.suˈnɛ̃.wa
wyszedł	ˈvɨ.ʂɛdw
wyszła	ˈvɨ.ʂwa
wyższe	ˈvɨʂ.ʂɛ
wyżyć	ˈvɨ.ʐɨt͡ɕ
wziąć	vʑɔɲt͡ɕ
wziął	vʑɔ̃w
wzięła	ˈvʑɛ̃.wa
wzleciał	ˈvzlɛ.t͡ɕaw
wzleciała	vzlɛˈt͡ɕa.wa
wznosił	ˈvznɔ.ɕiw
wzruszenia	vzruˈʂɛ.ɲa
właśnie	ˈvwaɕ.ɲɛ
wślizgnęły	fɕlʲizˈɡnɛ̃.wɨ
wśród	fɕrut
z	s
za	za
zabił	ˈza.bʲiw
zabrali	ˈza.braˈlʲ.i
zabrać	ˈza.brat͡ɕ
zabrała	zaˈbra.wa
zachodzie	zaˈxɔ.d͡ʑɛ
zachwycona	za.xfɨˈt͡sɔ.na
zaczęli	ˈza.t͡ʂɛˈlʲ.i
zaczął	ˈza.t͡ʂɔ̃w
zaczęła	zaˈt͡ʂɛ̃.wa
zaczęły	zaˈt͡ʂɛ̃.wɨ
zadecydowały	za.dɛ.t͡sɨ.dɔˈva.wɨ
zadowoleniem	za.dɔ.vɔˈlɛ.ɲɛm
zająć	ˈza.jɔɲt͡ɕ
zajęła	zaˈjɛ̃.wa
zakochał	zaˈkɔ.xaw
zamieniło	za.mʲɛˈɲi.wɔ
zamierza	zaˈmʲɛ.ʐa
zamknięte	zamˈkɲɛn.tɛ
zamknięty	zamˈkɲɛn.tɨ
zaniosę	zaˈɲɔ.sɛ
zaniosła	zaˈɲɔ.swa
zanurzone	za.nuˈʐɔ.nɛ
zaopatrzona	za.ɔ.patˈʂɔ.na
zapach	ˈza.pax
zapadając	za.paˈda.jɔnt͡s
zapewne	zaˈpɛv.nɛ
zapewniony	za.pɛvˈɲɔ.nɨ
zapomniał	zaˈpɔm.ɲaw
zapomnieć	zaˈpɔm.ɲɛt͡ɕ
zapragnął	zaˈpraɡ.nɔ̃w
zapytał	zaˈpɨ.taw
zapłaciła	za.pwaˈt͡ɕi.wa
zaraz	ˈza.ras
zarazem	zaˈra.zɛm
zasadziła	za.saˈd͡ʑi.wa
zasadź	ˈza.sat͡ɕ
zasiadła	zaˈɕa.dwa
zasnąć	ˈzas.nɔɲt͡ɕ
zastępował	za.stɛmˈpɔ.vaw
zaszczebiotała	zaʂ.t͡ʂɛ.bʲɔˈta.wa
zatkany	zatˈka.nɨ
zatknął	ˈzat.knɔ̃w
zatrzymała	zat.ʂɨˈma.wa
zawdzięczam	zavˈd͡ʑɛn.t͡ʂam
zawiesiła	za.vʲɛˈɕi.wa
zawołała	za.vɔˈwa.wa
zawstydzona	zaf.stɨˈd͡zɔ.na
zaświeciło	zaɕ.fʲɛˈt͡ɕi.wɔ
zboża	ˈzbɔ.ʐa
zboże	ˈzbɔ.ʐɛ
zbożem	ˈzbɔ.ʐɛm
zbudował	zbuˈdɔ.vaw
zbudziła	zbuˈd͡ʑi.wa
zbyt	zbɨt
zdania	ˈzda.ɲa
zdanie	ˈzda.ɲɛ
zdarza	ˈzda.ʐa
zdjął	zdjɔ̃w
zdjęła	ˈzdjɛ̃.wa
zdobyć	ˈzdɔ.bɨt͡ɕ
zdrowa	ˈzdrɔ.va
zdrętwiał	ˈzdrɛn.tfʲaw
zdziwiła	zd͡ʑiˈvʲi.wa
ze	zɛ
zebrały	zɛˈbra.wɨ
zesztywniałe	zɛʂ.tɨvˈɲa.wɛ
zgodziła	zɡɔˈd͡ʑi.wa
zgrabniejsza	zɡrabˈɲɛj.ʂa
ziarnko	ˈʑar.nkɔ
zielone	ʑɛˈlɔ.nɛ
zielonego	ʑɛ.lɔˈnɛ.ɡɔ
zielonym	ʑɛˈlɔ.nɨm
zielonymi	ʑɛˈlɔ.nɨˈmʲ.i
ziemi	ʑɛˈmʲ.i
ziemią	ˈʑɛ.mʲɔ̃
ziemię	ˈʑɛ.mʲɛ
zima	ˈʑi.ma
zimna	ˈʑim.na
zimno	ˈʑim.nɔ
zimę	ˈʑi.mɛ
zjawił	ˈzja.vʲiw
zjemy	ˈzjɛ.mɨ
zmarznie	ˈzmaʐ.ɲɛ
zmarzniętej	zmaʐˈɲɛn.tɛj
zmęczony	zmɛnˈt͡ʂɔ.nɨ
znaczył	ˈzna.t͡ʂɨw
znajdowało	znaj.dɔˈva.wɔ
znalazła	znaˈla.zwa
znaleźć	ˈzna.lɛɕt͡ɕ
znamy	ˈzna.mɨ
znieść	zɲɛɕt͡ɕ
zniknął	ˈzɲik.nɔ̃w
zniknęła	zɲikˈnɛ̃.wa
znowu	ˈznɔ.vu
znów	znuf
zobaczy	zɔˈba.t͡ʂɨ
zobaczysz	zɔˈba.t͡ʂɨʂ
zobaczyć	zɔˈba.t͡ʂɨt͡ɕ
zobaczyła	zɔ.baˈt͡ʂɨ.wa
zostają	zɔˈsta.jɔ̃
zostać	ˈzɔ.stat͡ɕ
zostań	ˈzɔ.staɲ
została	zɔˈsta.wa
zowie	ˈzɔ.vʲɛ
zranione	zraˈɲɔ.nɛ
zresztą	ˈzrɛʂ.tɔ̃
zrobię	ˈzrɔ.bʲɛ
zrobiłabyś	zrɔ.bʲiˈwa.bɨɕ
zrobiło	zrɔˈbʲi.wɔ
zupełnie	zuˈpɛw.ɲɛ
zwiądł	zvʲɔndw
zwyczajne	zvɨˈt͡ʂaj.nɛ
zwyczajnym	zvɨˈt͡ʂaj.nɨm
zwykle	ˈzvɨk.lɛ
zziębnięta	zʑɛmˈbɲɛn.ta
ząbkami	ˈzɔm.pkaˈmʲ.i
złe	zwɛ
złocistej	zwɔˈt͡ɕi.stɛj
złote	ˈzwɔ.tɛ
złotopurpurowy	zwɔ.tɔ.pur.puˈrɔ.vɨ
złotą	ˈzwɔ.tɔ̃
złożyć	ˈzwɔ.ʐɨt͡ɕ
zżęto	ˈzʐɛn.tɔ
łabędzi	ˈwa.bɛˈd͡ʑ.i
ładna	ˈwad.na
żadne	ˈʐad.nɛ
ładnie	ˈwa.dɲɛ
żal	ʐal
źdźbła	ʑd͡ʑbwa
że	ʐɛ
żebraczek	ʐɛˈbra.t͡ʂɛk
żeby	ˈʐɛ.bɨ
żebym	ˈʐɛ.bɨm
żegnaj	ˈʐɛɡ.naj
żegnam	ˈʐɛɡ.nam
ślepy	ˈɕlɛ.pɨ
śliczne	ˈɕlʲit͡ʂ.nɛ
ślicznie	ˈɕlʲit͡ʂ.ɲɛ
śliczną	ˈɕlʲit͡ʂ.nɔ̃
śmiali	ɕmʲaˈlʲ.i
śmieszny	ˈɕmʲɛʂ.nɨ
śmietance	ɕmʲɛˈtan.t͡sɛ
śnieg	ɕɲɛk
śniegiem	ˈɕɲɛ.ɡʲɛm
śniegu	ˈɕɲɛ.ɡu
łodyżki	ˈwɔ.dɨʂˈkʲ.i
żona	ˈʐɔ.na
żoną	ˈʐɔ.nɔ̃
żonę	ˈʐɔ.nɛ
łoskotem	wɔˈskɔ.tɛm
śpieszyły	ɕpʲɛˈʂɨ.wɨ
śpiewaczce	ɕpʲɛˈvat͡ʂ.t͡sɛ
śpiewają	ɕpʲɛˈva.jɔ̃
śpiewać	ˈɕpʲɛ.vat͡ɕ
śpiewała	ɕpʲɛˈva.wa
śpiewały	ɕpʲɛˈva.wɨ
śpiewu	ˈɕpʲɛ.vu
śpiącą	ˈɕpʲɔn.t͡sɔ̃
środek	ˈɕrɔ.dɛk
środka	ˈɕrɔt.ka
środku	ˈɕrɔt.ku
łupinkę	wuˈpʲin.kɛ
łupinę	wuˈpʲi.nɛ
świat	ɕfʲat
światła	ˈɕfʲa.twa
światło	ˈɕfʲa.twɔ
świeci	ɕfʲɛˈt͡ɕ.i
świecie	ˈɕfʲɛ.t͡ɕɛ
świeciło	ɕfʲɛˈt͡ɕi.wɔ
świergotu	ɕfʲɛrˈɡɔ.tu
życia	ˈʐɨ.t͡ɕa
życie	ˈʐɨ.t͡ɕɛ
życzenia	ʐɨˈt͡ʂɛ.ɲa
żyta	ˈʐɨ.ta
żywiła	ʐɨˈvʲi.wa
żyć	ʐɨt͡ɕ
żył	ʐɨw
łzami	wzaˈmʲ.i
łódkę	ˈwut.kɛ
łóżeczko	wuˈʐɛt͡ʂ.kɔ
łóżeczku	wuˈʐɛt͡ʂ.ku
żółtych	ˈʐuw.tɨx
łąki	wɔ̃ˈkʲ.i
łąkę	ˈwɔŋ.kɛ
bajki	bajˈkʲ.i
boga	ˈbɔ.ɡa
filozof	fʲiˈlɔ.zɔf
firmament	fʲirˈma.mɛnt
ignacy	iɡˈna.t͡sɨ
krasicki	ˈkra.ɕit͡sˈkʲ.i
mierzył	ˈmʲɛ.ʐɨw
mędrzec	ˈmɛn.dʐɛt͡s
pana	ˈpa.na
przedsięwziętych	pʂɛt.ɕɛ̃vˈʑɛn.tɨx
przypowieści	pʂɨˈpɔ.vʲɛɕˈt͡ɕ.i
przyszła	ˈpʂɨ.ʂwa
słabość	ˈswa.bɔɕt͡ɕ
upiry	uˈpʲi.rɨ
wierzył	ˈvʲɛ.ʐɨw
zaufany	zaˈwfa.nɨ
zdaniach	ˈzda.ɲax
śmiał	ɕmʲaw
świętych	ˈɕfʲɛn.tɨx
