a capella	a kaˈpɛl.la
Aachen	ˈa.xɛn
Aaron	ˈa.rɔn
Aarona	aˈrɔ.na
Aaronach	aˈrɔ.nax
Aaronami	a.rɔˈna.mʲi
Aaronami	aˈrɔ.naˈmʲ.i
Aaronem	aˈrɔ.nɛm
Aaroni	ˈa.rɔˈɲ.i
Aaroni	aˈrɔ.ɲi
Aaronie	aˈrɔ.ɲɛ
Aaronom	aˈrɔ.nɔm
Aaronów	aˈrɔ.nuf
aaronowa	a.rɔˈnɔ.va
aaronową	a.rɔˈnɔ.vɔ̃
aaronowe	a.rɔˈnɔ.vɛ
aaronowego	a.rɔ.nɔˈvɛ.ɡɔ
aaronowej	a.rɔˈnɔ.vɛj
aaronowemu	a.rɔ.nɔˈvɛ.mu
Aaronowi	a.rɔˈnɔ.vʲi
aaronowi	aˈrɔ.nɔˈvʲ.i
Aaronowi	aˈrɔ.nɔˈvʲ.i
Aaronowie	a.rɔˈnɔ.vʲɛ
aaronowo	a.rɔˈnɔ.vɔ
aaronowy	a.rɔˈnɔ.vɨ
aaronowych	a.rɔˈnɔ.vɨx
aaronowym	a.rɔˈnɔ.vɨm
aaronowymi	a.rɔˈnɔ.vɨˈmʲ.i
Aarony	aˈrɔ.nɨ
Abuzei	aˈbu.zɛj
Acciona	akˈsjɔ.na
Accioną	akˈsjɔ.nɔ̃
Accionę	akˈsjɔ.nɛ
Accionie	akˈsjɔ.ɲɛ
Acciony	akˈsjɔ.nɨ
adieu	ˈad.jɛ
Adobe	ˈɛ.dɔwˈbʲ.i
Adobe	ɛˈdɔw.bʲi
Agile'a	aˈd͡ʐaj.la
Agile'a	ɛˈd͡ʐaj.la
Agile'em	aˈd͡ʐaj.lɛm
Agile'em	ɛˈd͡ʐaj.lɛm
Agile'ową	a.d͡ʐajˈlɔ.vɔ̃
Agile'ową	ɛ.d͡ʐajˈlɔ.vɔ̃
Agile'owe	a.d͡ʐajˈlɔ.vɛ
Agile'owe	ɛ.d͡ʐajˈlɔ.vɛ
Agile'owego	a.d͡ʐaj.lɔˈvɛ.ɡɔ
Agile'owego	ɛ.d͡ʐaj.lɔˈvɛ.ɡɔ
Agile'owym	a.d͡ʐajˈlɔ.vɨm
Agile'owym	ɛ.d͡ʐajˈlɔ.vɨm
Agile'owymi	a.d͡ʐajˈlɔ.vɨˈmʲ.i
Agile'owymi	ɛ.d͡ʐaj.lɔˈvɨ.mʲi
Agile'owymi	ɛ.d͡ʐajˈlɔ.vɨˈmʲ.i
Agile'u	aˈd͡ʐaj.lu
Agile'u	ɛˈd͡ʐaj.lu
aids	ɛjts
Aires	ˈa.jrɛs
Ajaib-Gher	a.d͡ʐaˈip.ɡɛr
Alençon	aˈlɛn.kɔ̃
Alexander	a.lɛkˈsan.dɛr
Allardyce	aˈlar.dajs
Allardyce'a	a.larˈdaj.sa
Alvaro	alˈva.rɔ
alzheimer	alˈt͡sxaj.mɛr
alzheimera	al.t͡sxajˈmɛ.ra
alzheimerem	al.t͡sxajˈmɛ.rɛm
alzheimerowi	al.t͡sxajˈmɛ.rɔˈvʲ.i
alzheimerze	al.t͡sxajˈmɛ.ʐɛ
amic	ˈa.mʲik
amicą	aˈmʲi.kɔ̃
amicach	aˈmʲi.kax
amicami	aˈmʲi.kaˈmʲ.i
amicę	aˈmʲi.kɛ
amico	aˈmʲi.kɔ
amicom	aˈmʲi.kɔm
amiki	ˈa.mʲiˈkʲ.i
Andree	ˈan.drɛ
Andreę	ˈan.drɛ
Andrieux'mu	an.drʲiˈjɛ.mu
Angeles	anˈd͡ʐɛ.lɛs
Angoulême	anˈɡu.lɛm
Arrow	ˈa.rɔw
Arrowa	aˈrɔ.wa
Auge	ɔk
Auschwitz	ˈaw.ʂfʲit͡s
Auschwitz-Birkenau	aw.ʂfʲit͡s.bʲirˈkɛ.naw
avant	ˈa.van
avią	ˈa.vʲɔ̃
aviach	ˈa.vʲax
aviami	ˈa.vʲaˈmʲ.i
avie	ˈa.vʲɛ
avię	ˈa.vʲɛ
avii	aˈvʲi.i
avio	ˈa.vʲɔ
aviom	ˈa.vʲɔm
axel	ˈak.sɛl
Babenhausen	ba.bɛnˈxaw.zɛn
baedeker	bɛˈdɛ.kɛr
Baedeker	bɛˈdɛ.kɛr
baedekera	bɛ.dɛˈkɛ.ra
Baedekera	bɛ.dɛˈkɛ.ra
baedekerach	bɛ.dɛˈkɛ.rax
Baedekerach	bɛ.dɛˈkɛ.rax
Baedekerami	bɛ.dɛ.kɛˈra.mʲi
baedekerami	bɛ.dɛˈkɛ.raˈmʲ.i
Baedekerami	bɛ.dɛˈkɛ.raˈmʲ.i
baedekerem	bɛ.dɛˈkɛ.rɛm
Baedekerem	bɛ.dɛˈkɛ.rɛm
baedekerom	bɛ.dɛˈkɛ.rɔm
Baedekerom	bɛ.dɛˈkɛ.rɔm
baedekerów	bɛ.dɛˈkɛ.ruf
Baedekerów	bɛ.dɛˈkɛ.ruf
Baedekerowi	bɛ.dɛ.kɛˈrɔ.vʲi
baedekerowi	bɛ.dɛˈkɛ.rɔˈvʲ.i
Baedekerowi	bɛ.dɛˈkɛ.rɔˈvʲ.i
Baedekerowie	bɛ.dɛ.kɛˈrɔ.vʲɛ
baedekery	bɛ.dɛˈkɛ.rɨ
Baedekery	bɛ.dɛˈkɛ.rɨ
baedekerze	bɛ.dɛˈkɛ.ʐɛ
Baedekerze	bɛ.dɛˈkɛ.ʐɛ
Bailey	ˈbaj.lɛj
Bailey	ˈbɛj.lʲi
Bailey	bɛjˈlʲ.i
Bakerowi	bɛ.kɛˈrɔ.vʲi
Bakerowi	bɛˈkɛ.rɔˈvʲ.i
Ballantyne'a	bal.lanˈtɨ.na
Balzac	ˈbal.zak
Bartolomee	bar.tɔˈlɔ.mɛ
Bartolomeę	bar.tɔˈlɔ.mɛ
bass	bɛjs
Baudraye	ˈbɔ.drɛj
Bayeux	ˈba.jɛ
Beaudenord	bɔˈdɛ.nɔrt
Beaudenorda	bɔ.dɛˈnɔr.da
Beaujon	ˈbɔ.ʐɔ̃
Beauséant	ˈbʲi.zɔ̃
Beauséantów	bʲiˈzan.tuf
Becka	ˈbɛ.ka
Beckach	ˈbɛ.kax
Beckami	ˈbɛ.kaˈmʲ.i
Beckami	bɛˈka.mʲi
Becki	ˈbɛ.kʲi
Becki	bɛˈkʲ.i
Beckiem	ˈbɛ.kʲɛm
Beckom	ˈbɛ.kɔm
Becków	ˈbɛ.kuf
Beckowi	ˈbɛ.kɔˈvʲ.i
Beckowi	bɛˈkɔ.vʲi
Beckowie	bɛˈkɔ.vʲɛ
Becku	ˈbɛ.ku
Bejart	ˈbɛ.ʐart
Belize	ˈbɛ.lʲis
Benbow	ˈbɛn.bɔw
Benjamin	bɛˈɲa.mʲin
Benjamin	bɛnˈd͡ʐa.mʲin
Benjamina	bɛ.ɲaˈmʲi.na
Benjamina	bɛn.d͡ʐaˈmʲi.na
Benjaminach	bɛ.ɲaˈmʲi.nax
Benjaminach	bɛn.d͡ʐaˈmʲi.nax
Benjaminami	bɛ.ɲa.mʲiˈna.mʲi
Benjaminami	bɛ.ɲaˈmʲi.naˈmʲ.i
Benjaminami	bɛn.d͡ʐaˈmʲi.naˈmʲ.i
Benjaminem	bɛ.ɲaˈmʲi.nɛm
Benjaminem	bɛn.d͡ʐaˈmʲi.nɛm
Benjaminie	bɛ.ɲaˈmʲi.ɲɛ
Benjaminie	bɛn.d͡ʐaˈmʲi.ɲɛ
Benjaminom	bɛ.ɲaˈmʲi.nɔm
Benjaminom	bɛn.d͡ʐaˈmʲi.nɔm
Benjaminów	bɛ.ɲaˈmʲi.nuf
Benjaminów	bɛn.d͡ʐaˈmʲi.nuf
Benjaminowi	bɛ.ɲa.mʲiˈnɔ.vʲi
Benjaminowi	bɛ.ɲaˈmʲi.nɔˈvʲ.i
Benjaminowi	bɛn.d͡ʐaˈmʲi.nɔˈvʲ.i
Benjaminowie	bɛ.ɲa.mʲiˈnɔ.vʲɛ
Benjaminowie	bɛn.d͡ʐa.mʲiˈnɔ.vʲɛ
Benjaminy	bɛ.ɲaˈmʲi.nɨ
Benjaminy	bɛn.d͡ʐaˈmʲi.nɨ
Bérangera	bɛ.ranˈʐɛ.ra
Bernard	ˈbɛr.nar
Bessin	ˈbʲi.sɛ
Bianchon	ˈbʲan.ʂɔn
Bianchona	bʲanˈʂɔ.na
Bianchonem	bʲɛŋˈʂɔ.nɛm
Bianchonem	bʲɛ̃ˈʂɔ.nɛm
Bill	bʲil
Billa	ˈbʲi.la
Billem	ˈbʲi.lɛm
Billowi	ˈbʲi.lɔˈvʲ.i
Billowi	bʲiˈlɔ.vʲi
Billu	ˈbʲi.lu
Billy	ˈbʲi.lʲi
Billy	bʲiˈlʲ.i
Birkenau	bʲirˈkɛ.naw
Birotteau	bʲiˈrɔ.tɔ
Bixiou	ˈbʲik.sɔ
Bizet	ˈbʲi.zɛ
Black	blak
Blamontów-Chauvry	bla.mɔn.tufˈʂɛv.rʲi
Blandly	ˈblan.dlʲi
Blandly	blantˈlʲ.i
Blandly	blɛntˈlʲ.i
Blandly'ego	blanˈdlʲɛ.ɡɔ
Blois	ˈblu.a
Blondet	ˈblɔn.dɛ
Blondeta	ˈblɔn.dɛ
Boccaccia	bɔˈkat͡ʂ.ja
Boccacciach	bɔˈkat͡ʂ.jax
Boccacciami	bɔ.kat͡ʂˈja.mʲi
Boccacciami	bɔˈkat͡ʂ.jaˈmʲ.i
Boccaccie	bɔˈkat͡ʂ.jɛ
Boccacciem	bɔˈkat͡ʂ.jɛm
Boccaccio	bɔˈkat͡ʂ.jɔ
Boccacciom	bɔˈkat͡ʂ.jɔm
Boccacciów	bɔˈkat͡ʂ.juf
Boccacciowi	bɔ.kat͡ʂˈjɔ.vʲi
Boccacciowi	bɔˈkat͡ʂ.jɔˈvʲ.i
Boccacciowie	bɔ.kat͡ʂˈjɔ.vʲɛ
Boccacciu	bɔˈkat͡ʂ.ju
Boegego	bɛˈɡɛ.ɡɔ
Boileau	ˈbwa.lɔ
Boirouge	ˈbɔ.rɔʂ
Bones	bɔns
Bonesa	ˈbɔn.sa
Bordeaux	ˈbɔr.dɔ
Bossuet	ˈbɔ.swɛ
Bouffégo	buˈfʲɛ.ɡɔ
Bourdaloue	burˈdɛ.lu
Bouret	ˈbu.rɛ
bourgeois	ˈbur.ʐwa
Bow	bɔw
Breilman	ˈbrɛj.lmɔ̃
Breilmana	brɛjˈlma.na
bruits	bru
brumaire	ˈbru.mɛr
Buckle'a	ˈbak.la
Buckle'ów	ˈbak.luf
Buenos	ˈbwɛ.nɔs
Buffalo	buˈfa.lɔ
cacao-choix	ka.kawˈʂu.wa
Cadignanów	ka.diˈɲɔ.nuf
cafe	ˈka.fɛ
Calypso	kaˈlʲip.sɔ
canal	ˈka.nal
Cannareggio	ka.na.rɛˈd͡ʐi.ɔ
canon	ˈka.nɔn
canona	kaˈnɔ.na
canonach	kaˈnɔ.nax
canonami	kaˈnɔ.naˈmʲ.i
canonem	kaˈnɔ.nɛm
canonie	kaˈnɔ.ɲɛ
canonom	kaˈnɔ.nɔm
canonów	kaˈnɔ.nuf
canonowi	kaˈnɔ.nɔˈvʲ.i
canony	kaˈnɔ.nɨ
Capri	ˈkap.rʲi
Capri	kapˈrʲ.i
Capricioso	kap.rʲiˈt͡ʂɔ.zɔ
Caracas	kaˈra.kas
Castle	kastl
Cayla	ˈsɛ.la
cerceau	ˈsɛr.sɔ
Cervantes	sɛrˈvan.tɛs
Cervantesa	sɛr.vanˈtɛ.sa
chambre	ʂambr
Champignelles	ʂamˈpʲi.ɲɛl
Champignon	ʂamˈpʲi.ɲɔ̃
Champmeslé	ˈʂam.plɛs
Chargeboeuf	ʂarˈʐɛ.bɔf
Charles	ʂarl
Charles	t͡ʂarls
Charles'a	ˈʂar.la
Charlesa	ˈt͡ʂar.lsa
Charles'ach	ˈʂar.lax
Charlesach	ˈt͡ʂar.lsax
Charles'ami	ˈʂar.laˈmʲ.i
Charles'ami	ʂarˈla.mʲi
Charlesami	ˈt͡ʂar.lsaˈmʲ.i
Charlesami	t͡ʂarˈlsa.mʲi
Charles'e	ˈʂar.lɛ
Charles'em	ˈʂar.lɛm
Charlesem	ˈt͡ʂar.lsɛm
Charlesie	ˈt͡ʂar.lɕɛ
Charles'om	ˈʂar.lɔm
Charlesom	ˈt͡ʂar.lsɔm
Charles'ów	ˈʂar.luf
Charlesów	ˈt͡ʂar.lsuf
Charles'owi	ˈʂar.lɔˈvʲ.i
Charles'owi	ʂarˈlɔ.vʲi
Charlesowi	ˈt͡ʂar.lsɔˈvʲ.i
Charlesowi	t͡ʂarˈlsɔ.vʲi
Charles'owie	ʂarˈlɔ.vʲɛ
Charlesowie	t͡ʂarˈlsɔ.vʲɛ
charleston	ˈt͡ʂar.lstɔn
charlestona	t͡ʂarˈlstɔ.na
charlestonach	t͡ʂarˈlstɔ.nax
charlestonami	t͡ʂarˈlstɔ.naˈmʲ.i
charlestonem	t͡ʂarˈlstɔ.nɛm
Charlestonem	t͡ʂarˈlstɔ.nɛm
charlestonie	t͡ʂarˈlstɔ.ɲɛ
Charlestonie	t͡ʂarˈlstɔ.ɲɛ
charlestonom	t͡ʂarˈlstɔ.nɔm
charlestonów	t͡ʂarˈlstɔ.nuf
Charlestonowi	t͡ʂar.lstɔˈnɔ.vʲi
charlestonowi	t͡ʂarˈlstɔ.nɔˈvʲ.i
Charlestonowi	t͡ʂarˈlstɔ.nɔˈvʲ.i
Charlestonu	t͡ʂarˈlstɔ.nu
charlestony	t͡ʂarˈlstɔ.nɨ
Charles'u	ˈʂar.lu
Charlesy	ˈt͡ʂar.lsɨ
Châteigneraie	ʂa.tɛˈɲi.rɛj
Chaumontel	ʂawˈmɔn.tɛl
chip	t͡ʂip
chips	t͡ʂips
chipsa	ˈt͡ʂip.sa
chipsach	ˈt͡ʂip.sat͡ʂ
chipsami	ˈt͡ʂip.saˈmʲ.i
chipsem	ˈt͡ʂip.sɛm
chipsie	ˈt͡ʂip.ɕɛ
chipsom	ˈt͡ʂip.sɔm
chipsów	ˈt͡ʂip.suf
chipsowi	ˈt͡ʂip.sɔˈvʲ.i
chipsy	ˈt͡ʂip.sɨ
Chodoreille	ʂɔˈdɔ.rɛjl
Chopin	ˈʂɔ.pɛn
Chopina	ʂɔˈpɛ.na
Chopinach	ʂɔˈpɛ.nax
Chopinami	ʂɔ.pɛˈna.mʲi
Chopinami	ʂɔˈpɛ.naˈmʲ.i
Chopinem	ʂɔˈpɛ.nɛm
Chopinie	ʂɔˈpɛ.ɲɛ
Chopinom	ʂɔˈpɛ.nɔm
Chopinów	ʂɔˈpɛ.nuf
Chopinowi	ʂɔ.pɛˈnɔ.vʲi
Chopinowi	ʂɔˈpɛ.nɔˈvʲ.i
Chopinowie	ʂɔ.pɛˈnɔ.vʲɛ
chopinowscy	ʂɔ.pɛˈnɔf.st͡sɨ
chopinowska	ʂɔ.pɛˈnɔf.ska
chopinowską	ʂɔ.pɛˈnɔf.skɔ̃
chopinowskich	ʂɔ.pɛˈnɔf.skʲix
chopinowskie	ʂɔ.pɛˈnɔf.skʲɛ
chopinowskiego	ʂɔ.pɛ.nɔfˈskʲɛ.ɡɔ
chopinowskiej	ʂɔ.pɛˈnɔf.skʲɛj
chopinowskiemu	ʂɔ.pɛ.nɔfˈskʲɛ.mu
chopinowskim	ʂɔ.pɛˈnɔf.skʲim
chopinowskimi	ʂɔ.pɛˈnɔf.skʲiˈmʲ.i
chopinowsko	ʂɔ.pɛˈnɔf.skɔ
chopinowsku	ʂɔ.pɛˈnɔf.sku
Chopiny	ʂɔˈpɛ.nɨ
choree	ˈxɔ.rɛ
choreę	ˈxɔ.rɛ
chrysler	ˈkraj.slɛr
chrysler	ˈkraj.zlɛr
chryslera	krajˈslɛ.ra
chryslera	krajˈzlɛ.ra
chryslerach	krajˈslɛ.rax
chryslerach	krajˈzlɛ.rax
chryslerami	krajˈslɛ.raˈmʲ.i
chryslerami	krajˈzlɛ.raˈmʲ.i
chryslerem	krajˈslɛ.rɛm
chryslerem	krajˈzlɛ.rɛm
chryslerom	krajˈslɛ.rɔm
chryslerom	krajˈzlɛ.rɔm
chryslerów	krajˈslɛ.ruf
chryslerów	krajˈzlɛ.ruf
chryslerowi	krajˈslɛ.rɔˈvʲ.i
chryslerowi	krajˈzlɛ.rɔˈvʲ.i
chryslery	krajˈslɛ.rɨ
chryslery	krajˈzlɛ.rɨ
chryslerze	krajˈslɛ.ʐɛ
chryslerze	krajˈzlɛ.ʐɛ
cis	t͡sis
Cizy	ˈt͡si.zɨ
Clagny	ˈkla.ɲi
Clicôt	ˈklʲi.kɔ
Co	kɔ
Coeur	kɛr
Commibles	kɔmˈmʲib.lɛs
Conflans	ˈkɔ̃f.lɔ̃
Coopera	kuˈpɛ.ra
Corneille'a	kɔrˈnɛ.la
correct	ˈka.rɛkt
Corso	ˈkɔr.sɔ
Courcelles	ˈkɔr.sɛl
Couture	ˈkɔ.tu
Couture	ˈkɔ.tur
Couture'a	kɔˈtu.ra
Cove	kɔf
Credo	ˈkrɛ.dɔ
Creighton	ˈkrɛj.tɔn
Crevel	ˈkrɛ.vɛl
Crossley	ˈkrɔs.lʲi
Crossley	krɔsˈlʲ.i
Crossleyowej	krɔs.lɛˈjɔ.vɛj
Cruchot	ˈkru.ʂɔt
Cruchotów	kruˈʂɔ.tuf
Crusoe	ˈkru.zɔ
Cumberland	kamˈbɛr.lant
curaçao	kju.raˈsa.ɔ
curaçao	kuˈra.sɔ
Curie	ˈkʲi.rʲi
daewoo	ˈdɛ.wu
d'Aiglemont	daʐˈlɛ.mɔn
d'Ajuda	daˈʐu.da
d'Ajuda-Pinto	da.ʐu.daˈpʲin.tɔ
d'Aldrigger	dalˈdrʲi.ɡʐɛ
Dance	ˈdan.si
Dance'a	danˈsɛ.ja
d'Angers	ˈdan.ʐɛr
Darby	ˈdar.bʲi
Darby	darˈbʲ.i
Darbym	ˈdar.bʲim
Darci	ˈdar.t͡si
d'Aubrion	ˈdɛb.rʲɔn
d'Aubrion	ˈdɛb.rʲjɔn
David	ˈdɛj.vʲit
Davis	ˈdɛj.vʲis
dealerscy	diˈlɛr.st͡sɨ
dealerska	diˈlɛr.ska
dealerską	diˈlɛr.skɔ̃
dealerski	ˈdi.lɛrsˈkʲ.i
dealerskich	diˈlɛr.skʲix
dealerskie	diˈlɛr.skʲɛ
dealerskiego	di.lɛrˈskʲɛ.ɡɔ
dealerskiej	diˈlɛr.skʲɛj
dealerskiemu	di.lɛrˈskʲɛ.mu
dealerskim	diˈlɛr.skʲim
dealerskimi	diˈlɛr.skʲiˈmʲ.i
dealersko	diˈlɛr.skɔ
dealersku	diˈlɛr.sku
décolletage	dɛ.kɔˈlɛ.taʂ
Deli	ˈdɛ.lʲi
Deli	dɛˈlʲ.i
Derville'a	dɛrˈvʲi.la
des	dɛ
d'Escarbagnas	dɛ.skarˈba.ɲas
déshabillé	dɛ.ʂaˈbʲi.lɛ
déshabillé	dɛ.zaˈbʲi.lɛ
d'Espagne	ˈdɛ.spaɲ
d'Espard	ˈdɛ.spart
Despleina	ˈdɛ.splɛ
Desroches	ˈdɛ.rɔʂ
Desrochowi	dɛ.rɔˈʂɔ.vʲi
Desrochowi	dɛˈrɔ.ʂɔˈvʲ.i
Dick	dik
Dicku	ˈdi.ku
Diderot	diˈdɛ.rɔ
Dies	dɛs
Dinanatha	di.naˈna.ta
discoveries	di.skɔˈvɛ.rʲis
Ditties	diˈti.ɛs
Dogger	ˈdɔ.d͡ʐɛr
Doggera	dɔˈd͡ʐɛ.ra
domarzł	ˈdɔ.marzw
domarzła	dɔˈmar.zwa
domarzli	ˈdɔ.marsˈlʲ.i
domarzło	dɔˈmar.zwɔ
domarzłszy	dɔˈmar.zwʂɨ
domarzły	dɔˈmar.zwɨ
domarzną	dɔˈmar.znɔ̃
domarznąć	dɔˈmar.znɔɲt͡ɕ
domarznę	dɔˈmar.znɛ
domarznie	dɔˈmar.zɲɛ
domarznięci	dɔˈmar.zɲɛˈt͡ɕ.i
domarznięcia	dɔ.marˈzɲɛɲ.t͡ɕa
domarzniecie	dɔ.marˈzɲɛ.t͡ɕɛ
domarznięcie	dɔ.marˈzɲɛɲ.t͡ɕɛ
domarznięciem	dɔ.marˈzɲɛɲ.t͡ɕɛm
domarznięciu	dɔ.marˈzɲɛɲ.t͡ɕu
domarzniemy	dɔ.marˈzɲɛ.mɨ
domarzniesz	dɔˈmar.zɲɛʂ
domarznięta	dɔ.marˈzɲɛn.ta
domarzniętą	dɔ.marˈzɲɛn.tɔ̃
domarznięte	dɔ.marˈzɲɛn.tɛ
domarzniętego	dɔ.mar.zɲɛnˈtɛ.ɡɔ
domarzniętej	dɔ.marˈzɲɛn.tɛj
domarzniętemu	dɔ.mar.zɲɛnˈtɛ.mu
domarznięto	dɔ.marˈzɲɛn.tɔ
domarznięty	dɔ.marˈzɲɛn.tɨ
domarzniętych	dɔ.marˈzɲɛn.tɨx
domarzniętym	dɔ.marˈzɲɛn.tɨm
domarzniętymi	dɔ.marˈzɲɛn.tɨˈmʲ.i
domarznij	dɔˈmar.zɲij
domarznijcie	dɔ.marˈzɲij.t͡ɕɛ
domarznijmy	dɔ.marˈzɲij.mɨ
Douglas	ˈdaɡ.las
dreaming	ˈdrʲi.mʲink
du	di
Duberghe'a	di.uˈbɛ.ra
Dupré	ˈdu.prɛ
Duret	diˈu.rɛ
Effie	ˈɛ.fʲi
Effie	ɛˈfʲ.i
England	ˈin.ɡlant
Erie	ˈi.rʲi
Erie	iˈrʲ.i
Erytree	ɛˈrɨ.trɛ
Erytreę	ɛˈrɨ.trɛ
explorer	ɛkˈsplɔ.rɛr
explorera	ɛk.splɔˈrɛ.ra
explorerach	ɛk.splɔˈrɛ.rax
explorerami	ɛk.splɔˈrɛ.raˈmʲ.i
explorerem	ɛk.splɔˈrɛ.rɛm
explorerom	ɛk.splɔˈrɛ.rɔm
explorerów	ɛk.splɔˈrɛ.ruf
explorerowi	ɛk.splɔˈrɛ.rɔˈvʲ.i
explorery	ɛk.splɔˈrɛ.rɨ
explorerze	ɛk.splɔˈrɛ.ʐɛ
expo	ˈɛk.spɔ
expres	ˈɛk.sprɛ
expres	ˈɛk.sprɛs
facebook	ˈfɛj.sbuk
facebooka	fɛjˈsbu.ka
facebooki	ˈfɛj.sbuˈkʲ.i
facebookiem	fɛjˈsbu.kʲɛm
facebooku	fɛjˈsbu.ku
facto	ˈfak.tɔ
fair	fɛr
Farrell	ˈfa.rɛl
Farrella	faˈrɛ.la
Farrellach	faˈrɛ.lax
Farrellami	fa.rɛˈla.mʲi
Farrellami	faˈrɛ.laˈmʲ.i
Farrelle	faˈrɛ.lɛ
Farrellem	faˈrɛ.lɛm
Farrellom	faˈrɛ.lɔm
Farrellów	faˈrɛ.luf
Farrellowi	fa.rɛˈlɔ.vʲi
Farrellowi	faˈrɛ.lɔˈvʲ.i
Farrellowie	fa.rɛˈlɔ.vʲɛ
Farrellu	faˈrɛ.lu
Farry	ˈfa.rɨ
felichittà	fɛ.lʲiˈt͡ʂi.ta
Fieschiego	fʲiˈʂɛ.ɡɔ
Finn	fʲin
Finna	ˈfʲi.na
Finot	ˈfʲi.nɔ
fitness	ˈfʲit.nɛs
fixing	ˈfʲik.sink
Fontaine	ˈfɔn.tɛjn
Fontaine'a	fɔnˈtɛj.na
Fontenoy	fɔnˈtɛ.nɔj
food	fut
foodach	ˈfu.dax
foodami	ˈfu.daˈmʲ.i
foodem	ˈfu.dɛm
foodom	ˈfu.dɔm
foodów	ˈfu.duf
foodowi	ˈfu.dɔˈvʲ.i
foodu	ˈfu.du
foody	ˈfu.dɨ
foodzie	ˈfu.d͡ʑɛ
Fouqué'go	fɔˈkɛ.ɡɔ
Fuggerowie	fu.ʐɛˈrɔ.vʲɛ
Funambules	fuˈnam.bul
gallicum	ɡaˈlʲi.kum
Game	ɡɛjm
garson	ˈɡar.sɔ̃
Gaston	ˈɡa.stɔn
Gautiera	ɡɔ.tiˈɛ.ra
George	d͡ʐɔrt͡ʂ
George	ʐɔrʂ
George'a	ˈd͡ʐɔr.d͡ʐa
George'ach	ˈd͡ʐɔr.d͡ʐax
George'ami	d͡ʐɔrˈd͡ʐa.mʲi
George'e	ˈd͡ʐɔr.d͡ʐɛ
George'em	ˈd͡ʐɔr.d͡ʐɛm
Georgem	ˈd͡ʐɔr.d͡ʐɛm
George'om	ˈd͡ʐɔr.d͡ʐɔm
George'ów	ˈd͡ʐɔr.d͡ʐuf
George'owi	d͡ʐɔrˈd͡ʐɔ.vʲi
George'owie	d͡ʐɔrˈd͡ʐɔ.vʲɛ
George'u	ˈd͡ʐɔr.d͡ʐu
Gioconda	d͡ʐɛˈkɔn.da
Gioconda	d͡ʐjɔˈkɔn.da
Giovanni	ˈd͡ʑɔ.vaˈɲ.i
Giovanni	ˈd͡ʐjɔ.vaˈɲ.i
Giovanni	d͡ʐjɔˈva.ɲi
Giovannich	d͡ʑɔˈva.ɲix
Giovannich	d͡ʐjɔˈva.ɲix
Giovanniego	d͡ʑɔ.vaˈɲɛ.ɡɔ
Giovanniego	d͡ʐjɔ.vaˈɲɛ.ɡɔ
Giovanniemu	d͡ʑɔ.vaˈɲɛ.mu
Giovanniemu	d͡ʐjɔ.vaˈɲɛ.mu
Giovannim	d͡ʑɔˈva.ɲim
Giovannim	d͡ʐjɔˈva.ɲim
Giovannimi	d͡ʑɔˈva.ɲiˈmʲ.i
Giovannimi	d͡ʐjɔ.vaˈɲi.mʲi
Giovannimi	d͡ʐjɔˈva.ɲiˈmʲ.i
Godeschala	ɡɔ.dɛˈʂa.la
Goethe	ˈɡɛ.tɛ
Goethego	ɡɛˈtɛ.ɡɔ
goethowscy	ɡɛˈtɔf.st͡sɨ
goethowska	ɡɛˈtɔf.ska
goethowską	ɡɛˈtɔf.skɔ̃
goethowski	ˈɡɛ.tɔfsˈkʲ.i
goethowskich	ɡɛˈtɔf.skʲix
goethowskie	ɡɛˈtɔf.skʲɛ
goethowskiego	ɡɛ.tɔfˈskʲɛ.ɡɔ
goethowskiej	ɡɛˈtɔf.skʲɛj
goethowskiemu	ɡɛ.tɔfˈskʲɛ.mu
goethowskim	ɡɛˈtɔf.skʲim
goethowskimi	ɡɛˈtɔf.skʲiˈmʲ.i
goethowsko	ɡɛˈtɔf.skɔ
goethowsku	ɡɛˈtɔf.sku
Google	ˈɡuɡ.lɛ
Google	ɡuɡl
Goriot	ˈɡɔr.jɔ
grande	ɡrant
Grandlieu	ˈɡran.dlu
Gravelotte	ɡraˈvɛ.lɔt
Gravier	ˈɡra.vʲɛr
Gray	ɡrɛj
Graya	ˈɡrɛ.ja
Grayu	ˈɡrɛ.ju
Grimm	ɡrʲim
grooma	ˈɡrɔ.ma
Grossetête	ɡrɔˈsɛ.tɛt
Guenic	ˈɡɛ.ɲik
Gunn	ɡun
Gunna	ˈɡu.na
Gunnem	ˈɡu.nɛm
Gunnie	ˈɡu.ɲɛ
Gunnowi	ˈɡu.nɔˈvʲ.i
Gunnowi	ɡuˈnɔ.vʲi
gwinee	ˈɡvʲi.nɛ
gwineę	ˈɡvʲi.nɛ
Hands	xants
Hands	xɛnts
Handsa	ˈxan.tsa
Handsa	ˈxɛn.tsa
Handsowi	ˈxan.tsɔˈvʲ.i
Handsowi	xanˈtsɔ.vʲi
Handsowi	ˈxɛn.tsɔˈvʲ.i
hardcore'owa	xar.tkɔˈrɔ.va
hardcore'ową	xar.tkɔˈrɔ.vɔ̃
hardcore'owe	xar.tkɔˈrɔ.vɛ
hardcore'owego	xar.tkɔ.rɔˈvɛ.ɡɔ
hardcore'owej	xar.tkɔˈrɔ.vɛj
hardcore'owemu	xar.tkɔ.rɔˈvɛ.mu
hardcore'owi	xarˈtkɔ.rɔˈvʲ.i
hardcore'owo	xar.tkɔˈrɔ.vɔ
hardcore'owy	xar.tkɔˈrɔ.vɨ
hardcore'owych	xar.tkɔˈrɔ.vɨx
hardcore'owym	xar.tkɔˈrɔ.vɨm
hardcore'owymi	xar.tkɔˈrɔ.vɨˈmʲ.i
Harry	ˈxa.rʲi
Harry	xaˈrʲ.i
Harry'emu	xaˈrɛ.mu
Hawke	xawk
Hawkins	ˈxaw.kʲins
Hawkinsa	xawˈkʲin.sa
Hawkinsem	xawˈkʲin.sɛm
Hawkinsie	xawˈkʲin.ɕɛ
Hawkinsowi	xaw.kʲinˈsɔ.vʲi
Hawkinsowi	xawˈkʲin.sɔˈvʲ.i
hexe	ˈxɛk.sɛ
Hill	xʲil
histericus	xʲi.stɛˈrʲi.kus
Hol'	xɔl
Hollisowi	xɔ.lʲiˈsɔ.vʲi
Hollisowi	xɔˈlʲi.sɔˈvʲ.i
Holoubek	xɔˈlɔw.bɛk
Holoubek	xɔˈlu.bɛk
Holoubka	xɔˈlɔw.pka
Holoubka	xɔˈlup.ka
Holoubkach	xɔˈlɔw.pkax
Holoubkach	xɔˈlup.kax
Holoubkami	xɔ.lupˈka.mʲi
Holoubkami	xɔˈlɔw.pkaˈmʲ.i
Holoubkami	xɔˈlup.kaˈmʲ.i
Holoubki	ˈxɔ.lɔwpˈkʲ.i
Holoubki	ˈxɔ.lupˈkʲ.i
Holoubki	xɔˈlup.kʲi
Holoubkiem	xɔˈlɔw.pkʲɛm
Holoubkiem	xɔˈlup.kʲɛm
Holoubkom	xɔˈlɔw.pkɔm
Holoubkom	xɔˈlup.kɔm
Holoubków	xɔˈlɔw.pkuf
Holoubków	xɔˈlup.kuf
Holoubkowi	xɔ.lupˈkɔ.vʲi
Holoubkowi	xɔˈlɔw.pkɔˈvʲ.i
Holoubkowi	xɔˈlup.kɔˈvʲ.i
Holoubkowie	xɔ.lɔwˈpkɔ.vʲɛ
Holoubkowie	xɔ.lupˈkɔ.vʲɛ
Holoubku	xɔˈlɔw.pku
Holoubku	xɔˈlup.ku
Honoré	ɔˈnɔ.rɛ
Huck	xak
Hucka	ˈxa.ka
Huckleberry'ego	xak.lbɛˈrɛ.ɡɔ
Huckowi	ˈxa.kɔˈvʲ.i
Huckowi	xaˈkɔ.vʲi
Hugo	ˈi.ɡɔ
Hull	xal
Hunter	ˈxan.tɛr
Huntera	xanˈtɛ.ra
Hunterem	xanˈtɛ.rɛm
Hurree	ˈxu.rɛ
idee	ˈi.dɛ
ideę	ˈi.dɛ
illa	ˈi.la
immaculata	i.ma.kuˈla.ta
incognito	in.kɔɡˈɲi.tɔ
intermezzo	in.tɛrˈmɛt͡s.t͡sɔ
irae	ˈi.rɛ
Issoudun	iˈsɔ.dɔ
IT	ˈaj.ti
Jacob	ˈja.kɔp
Jadoo-Gher	jaˈdɔ.ɡɛr
jamais	ˈʐa.mɛ
Jarnac	ˈʐar.nak
Jarnaca	ʐarˈna.ka
Jean-Paula	ʐɛmˈpaw.la
Jeff	d͡ʐɛf
Jeffowi	ˈd͡ʐɛ.fɔˈvʲ.i
Jeffowi	d͡ʐɛˈfɔ.vʲi
Jim	d͡ʐim
Jima	ˈd͡ʐi.ma
Jimem	ˈd͡ʐi.mɛm
Jimie	ˈd͡ʐi.mʲɛ
Jimowi	ˈd͡ʐi.mɔˈvʲ.i
Jimowi	d͡ʐiˈmɔ.vʲi
Joann	ˈd͡ʐɔ.ann
Joanna	d͡ʐɔˈan.na
Joanną	d͡ʐɔˈan.nɔ̃
Joannach	d͡ʐɔˈan.nax
Joannami	d͡ʐɔ.anˈna.mʲi
Joannami	d͡ʐɔˈan.naˈmʲ.i
Joannę	d͡ʐɔˈan.nɛ
Joannie	d͡ʐɔˈan.ɲɛ
Joanno	d͡ʐɔˈan.nɔ
Joannom	d͡ʐɔˈan.nɔm
Joanny	d͡ʐɔˈan.nɨ
Job	d͡ʐɔp
Joba	ˈd͡ʐɔ.ba
Jobem	ˈd͡ʐɔ.bɛm
Jobowi	ˈd͡ʐɔ.bɔˈvʲ.i
Jobowi	d͡ʐɔˈbɔ.vʲi
Joby	ˈd͡ʐɔ.bʲi
Joby	d͡ʐɔˈbʲ.i
Joby'ego	d͡ʐɔˈbʲɛ.ɡɔ
John	d͡ʐɔn
Johna	ˈd͡ʐɔ.na
Johnem	ˈd͡ʐɔ.nɛm
Johnie	ˈd͡ʐɔ.ɲɛ
Johnny	ˈd͡ʐɔ.nɨ
Johnny'emu	d͡ʐɔˈnɛ.mu
Johnowi	ˈd͡ʐɔ.nɔˈvʲ.i
Johnowi	d͡ʐɔˈnɔ.vʲi
Johnsonie	d͡ʐɔnˈsɔ.ɲɛ
Joly	ˈʐɔ.lʲi
Joly	ʐɔˈlʲ.i
Jonatana	d͡ʐɔ.naˈta.na
Jordan	ˈd͡ʐɔr.dan
Jordana	d͡ʐɔrˈda.na
Jordanach	d͡ʐɔrˈda.nax
Jordanami	d͡ʐɔr.daˈna.mʲi
Jordanami	d͡ʐɔrˈda.naˈmʲ.i
Jordanem	d͡ʐɔrˈda.nɛm
Jordanie	d͡ʐɔrˈda.ɲɛ
Jordanom	d͡ʐɔrˈda.nɔm
Jordanów	d͡ʐɔrˈda.nuf
Jordanowi	d͡ʐɔr.daˈnɔ.vʲi
Jordanowi	d͡ʐɔrˈda.nɔˈvʲ.i
Jordanowie	d͡ʐɔr.daˈnɔ.vʲɛ
Jordany	d͡ʐɔrˈda.nɨ
Joyce	d͡ʐɔjs
Joyce'a	ˈd͡ʐɔj.sa
Juan	ˈʐu.an
Juana	ʐuˈa.na
Juanie	ʐuˈa.ɲɛ
Kain	kajn
Kaina	ˈkaj.na
Kainach	ˈkaj.nax
Kainami	ˈkaj.naˈmʲ.i
Kainami	kajˈna.mʲi
Kainem	ˈkaj.nɛm
Kainie	ˈkaj.ɲɛ
Kainom	ˈkaj.nɔm
Kainów	ˈkaj.nuf
Kainowi	ˈkaj.nɔˈvʲ.i
Kainowi	kajˈnɔ.vʲi
Kainowie	kajˈnɔ.vʲɛ
kamee	ˈka.mɛ
kameę	ˈka.mɛ
KE	ˈka.ɛ
key	kɛj
keyboard	ˈkʲi.bɔrt
keyboarda	kʲiˈbɔr.da
keyboardach	kʲiˈbɔr.dax
keyboardami	kʲiˈbɔr.daˈmʲ.i
keyboardem	kʲiˈbɔr.dɛm
keyboardom	kʲiˈbɔr.dɔm
keyboardów	kʲiˈbɔr.duf
keyboardowi	kʲiˈbɔr.dɔˈvʲ.i
keyboardu	kʲiˈbɔr.du
keyboardy	kʲiˈbɔr.dɨ
keyboardzie	kʲiˈbɔr.d͡ʑɛ
Kichot	ˈkʲi.ʂɔt
Kidda	ˈkʲi.da
Kimball	ˈkʲim.bal
Kimballa	kʲimˈba.la
Kitt	kʲit
Kitta	ˈkʲi.ta
klown	klawn
komisyia	kɔ.mʲiˈsɨ.ja
Köpenickiej	kɔ.pɛˈɲit͡s.kʲɛj
kredytowo-leasingowa	krɛ.dɨ.tɔ.vɔ.lʲi.zinˈɡɔ.va
kredytowo-leasingową	krɛ.dɨ.tɔ.vɔ.lʲi.zinˈɡɔ.vɔ̃
kredytowo-leasingowe	krɛ.dɨ.tɔ.vɔ.lʲi.zinˈɡɔ.vɛ
kredytowo-leasingowego	krɛ.dɨ.tɔ.vɔ.lʲi.zin.ɡɔˈvɛ.ɡɔ
kredytowo-leasingowej	krɛ.dɨ.tɔ.vɔ.lʲi.zinˈɡɔ.vɛj
kredytowo-leasingowemu	krɛ.dɨ.tɔ.vɔ.lʲi.zin.ɡɔˈvɛ.mu
kredytowo-leasingowi	krɛ.dɨ.tɔ.vɔ.lʲiˈzin.ɡɔˈvʲ.i
kredytowo-leasingowy	krɛ.dɨ.tɔ.vɔ.lʲi.zinˈɡɔ.vɨ
kredytowo-leasingowych	krɛ.dɨ.tɔ.vɔ.lʲi.zinˈɡɔ.vɨx
kredytowo-leasingowym	krɛ.dɨ.tɔ.vɔ.lʲi.zinˈɡɔ.vɨm
kredytowo-leasingowymi	krɛ.dɨ.tɔ.vɔ.lʲi.zinˈɡɔ.vɨˈmʲ.i
Kreutzner	ˈkrɔj.t͡snɛr
Kreutznerem	krɔjˈt͡snɛ.rɛm
Lacenaire'a	la.sɛˈnɛ.ra
Lamoignon	laˈmwa.ɲɔn
l'appassionata	la.pa.ɕɔˈna.ta
Law	lɛw
Lawa	ˈlɛ.wa
lead	lʲit
leadach	ˈlʲi.dax
leadami	ˈlʲi.daˈmʲ.i
leadem	ˈlʲi.dɛm
leadom	ˈlʲi.dɔm
leadów	ˈlʲi.duf
leadowi	ˈlʲi.dɔˈvʲ.i
leadu	ˈlʲi.du
leady	ˈlʲi.dɨ
leadzie	ˈlʲi.d͡ʑɛ
leasing	ˈlʲi.zink
leasingach	lʲiˈzin.ɡax
leasingami	lʲiˈzin.ɡaˈmʲ.i
leasingi	ˈlʲi.zinˈɡʲ.i
leasingiem	lʲiˈzin.ɡʲɛm
leasingobiorca	lʲi.zin.ɡɔˈbʲɔr.t͡sa
leasingobiorcą	lʲi.zin.ɡɔˈbʲɔr.t͡sɔ̃
leasingobiorcach	lʲi.zin.ɡɔˈbʲɔr.t͡sax
leasingobiorcami	lʲi.zin.ɡɔˈbʲɔr.t͡saˈmʲ.i
leasingobiorce	lʲi.zin.ɡɔˈbʲɔr.t͡sɛ
leasingobiorcę	lʲi.zin.ɡɔˈbʲɔr.t͡sɛ
leasingobiorco	lʲi.zin.ɡɔˈbʲɔr.t͡sɔ
leasingobiorcom	lʲi.zin.ɡɔˈbʲɔr.t͡sɔm
leasingobiorców	lʲi.zin.ɡɔˈbʲɔr.t͡suf
leasingobiorcy	lʲi.zin.ɡɔˈbʲɔr.t͡sɨ
leasingodawca	lʲi.zin.ɡɔˈdaf.t͡sa
leasingodawcą	lʲi.zin.ɡɔˈdaf.t͡sɔ̃
leasingodawcach	lʲi.zin.ɡɔˈdaf.t͡sax
leasingodawcami	lʲi.zin.ɡɔˈdaf.t͡saˈmʲ.i
leasingodawce	lʲi.zin.ɡɔˈdaf.t͡sɛ
leasingodawcę	lʲi.zin.ɡɔˈdaf.t͡sɛ
leasingodawco	lʲi.zin.ɡɔˈdaf.t͡sɔ
leasingodawcom	lʲi.zin.ɡɔˈdaf.t͡sɔm
leasingodawców	lʲi.zin.ɡɔˈdaf.t͡suf
leasingodawcy	lʲi.zin.ɡɔˈdaf.t͡sɨ
leasingom	lʲiˈzin.ɡɔm
leasingów	lʲiˈzin.ɡuf
leasingować	lʲi.zinˈɡɔ.vat͡ɕ
leasingował	lʲi.zinˈɡɔ.vaw
leasingowała	lʲi.zin.ɡɔˈva.wa
leasingowałaby	lʲi.zin.ɡɔ.vaˈwa.bɨ
leasingowałabym	lʲi.zin.ɡɔ.vaˈwa.bɨm
leasingowałabyś	lʲi.zin.ɡɔ.vaˈwa.bɨɕ
leasingowałam	lʲi.zin.ɡɔˈva.wam
leasingowałaś	lʲi.zin.ɡɔˈva.waɕ
leasingowałby	lʲi.zin.ɡɔˈvaw.bɨ
leasingowałbym	lʲi.zin.ɡɔˈvaw.bɨm
leasingowałbyś	lʲi.zin.ɡɔˈvaw.bɨɕ
leasingowałem	lʲi.zin.ɡɔˈva.wɛm
leasingowałeś	lʲi.zin.ɡɔˈva.wɛɕ
leasingowali	lʲi.zinˈɡɔ.vaˈlʲ.i
leasingowaliby	lʲi.zin.ɡɔ.vaˈlʲi.bɨ
leasingowalibyście	lʲi.zin.ɡɔ.va.lʲiˈbɨɕ.t͡ɕɛ
leasingowalibyśmy	lʲi.zin.ɡɔ.va.lʲiˈbɨɕ.mɨ
leasingowaliście	lʲi.zin.ɡɔ.vaˈlʲiɕ.t͡ɕɛ
leasingowaliśmy	lʲi.zin.ɡɔ.vaˈlʲiɕ.mɨ
leasingowało	lʲi.zin.ɡɔˈva.wɔ
leasingowałoby	lʲi.zin.ɡɔ.vaˈwɔ.bɨ
leasingowały	lʲi.zin.ɡɔˈva.wɨ
leasingowałyby	lʲi.zin.ɡɔ.vaˈwɨ.bɨ
leasingowałybyście	lʲi.zin.ɡɔ.va.wɨˈbɨɕ.t͡ɕɛ
leasingowałybyśmy	lʲi.zin.ɡɔ.va.wɨˈbɨɕ.mɨ
leasingowałyście	lʲi.zin.ɡɔ.vaˈwɨɕ.t͡ɕɛ
leasingowałyśmy	lʲi.zin.ɡɔ.vaˈwɨɕ.mɨ
leasingowań	lʲi.zinˈɡɔ.vaɲ
leasingowana	lʲi.zin.ɡɔˈva.na
leasingowaną	lʲi.zin.ɡɔˈva.nɔ̃
leasingowane	lʲi.zin.ɡɔˈva.nɛ
leasingowanego	lʲi.zin.ɡɔ.vaˈnɛ.ɡɔ
leasingowanej	lʲi.zin.ɡɔˈva.nɛj
leasingowanemu	lʲi.zin.ɡɔ.vaˈnɛ.mu
leasingowani	lʲi.zinˈɡɔ.vaˈɲ.i
leasingowania	lʲi.zin.ɡɔˈva.ɲa
leasingowaniach	lʲi.zin.ɡɔˈva.ɲax
leasingowaniami	lʲi.zin.ɡɔˈva.ɲaˈmʲ.i
leasingowanie	lʲi.zin.ɡɔˈva.ɲɛ
leasingowaniem	lʲi.zin.ɡɔˈva.ɲɛm
leasingowaniom	lʲi.zin.ɡɔˈva.ɲɔm
leasingowaniu	lʲi.zin.ɡɔˈva.ɲu
leasingowano	lʲi.zin.ɡɔˈva.nɔ
leasingowany	lʲi.zin.ɡɔˈva.nɨ
leasingowanych	lʲi.zin.ɡɔˈva.nɨx
leasingowanym	lʲi.zin.ɡɔˈva.nɨm
leasingowanymi	lʲi.zin.ɡɔˈva.nɨˈmʲ.i
leasingowi	lʲiˈzin.ɡɔˈvʲ.i
leasingu	lʲiˈzin.ɡu
leasinguj	lʲiˈzin.ɡuj
leasingują	lʲi.zinˈɡu.jɔ̃
leasingując	lʲi.zinˈɡu.jɔnt͡s
leasingująca	lʲi.zin.ɡuˈjɔn.t͡sa
leasingującą	lʲi.zin.ɡuˈjɔn.t͡sɔ̃
leasingujące	lʲi.zin.ɡuˈjɔn.t͡sɛ
leasingującego	lʲi.zin.ɡu.jɔnˈt͡sɛ.ɡɔ
leasingującej	lʲi.zin.ɡuˈjɔn.t͡sɛj
leasingującemu	lʲi.zin.ɡu.jɔnˈt͡sɛ.mu
leasingujący	lʲi.zin.ɡuˈjɔn.t͡sɨ
leasingujących	lʲi.zin.ɡuˈjɔn.t͡sɨx
leasingującym	lʲi.zin.ɡuˈjɔn.t͡sɨm
leasingującymi	lʲi.zin.ɡuˈjɔn.t͡sɨˈmʲ.i
leasingujcie	lʲi.zinˈɡuj.t͡ɕɛ
leasingujcież	lʲi.zinˈɡuj.t͡ɕɛʂ
leasinguje	lʲi.zinˈɡu.jɛ
leasinguję	lʲi.zinˈɡu.jɛ
leasingujecie	lʲi.zin.ɡuˈjɛ.t͡ɕɛ
leasingujemy	lʲi.zin.ɡuˈjɛ.mɨ
leasingujesz	lʲi.zinˈɡu.jɛʂ
leasingujmy	lʲi.zinˈɡuj.mɨ
leasingujmyż	lʲi.zinˈɡuj.mɨʂ
leasingujże	lʲi.zinˈɡuj.ʐɛ
Lemaître	ˈlɛ.matr
Lescaut	ˈlɛ.sku
l'expression	lɛkˈsprɛs.jɔ̃
Librivox	lʲibˈrʲi.vɔks
Librivox.org	lʲib.rʲi.vɔk.skrɔpˈka.ɔrk
Librivox.org	lʲib.rʲi.vɔkˈsdɔ.tɔrk
Lispeth	ˈlʲi.spɛt
littéraire	lʲiˈtɛ.rɛjr
Livesey	lʲiˈvɛ.sɛj
Liveseya	lʲi.vɛˈsɛ.ja
Liveseyem	lʲi.vɛˈsɛ.jɛm
Liveseyowi	lʲi.vɛ.sɛˈjɔ.vʲi
Liveseyowi	lʲi.vɛˈsɛ.jɔˈvʲ.i
Liveseyu	lʲi.vɛˈsɛ.ju
Louis	ˈlu.is
Lousteau	ˈlu.stɔ
Lucknow	ˈluk.nɔw
Lupeaulx	ˈlu.pɔl
mail	mɛjl
maila	ˈmɛj.la
mailach	ˈmɛj.lax
mailami	ˈmɛj.laˈmʲ.i
maile	ˈmɛj.lɛ
mailem	ˈmɛj.lɛm
maili	mɛjˈlʲ.i
mailing	ˈmɛj.lʲink
mailingach	mɛjˈlʲin.ɡax
mailingami	mɛjˈlʲin.ɡaˈmʲ.i
mailingi	ˈmɛj.lʲinˈɡʲ.i
mailingiem	mɛjˈlʲin.ɡʲɛm
mailingom	mɛjˈlʲin.ɡɔm
mailingów	mɛjˈlʲin.ɡuf
mailingowa	mɛj.lʲinˈɡɔ.va
mailingową	mɛj.lʲinˈɡɔ.vɔ̃
mailingowe	mɛj.lʲinˈɡɔ.vɛ
mailingowego	mɛj.lʲin.ɡɔˈvɛ.ɡɔ
mailingowej	mɛj.lʲinˈɡɔ.vɛj
mailingowemu	mɛj.lʲin.ɡɔˈvɛ.mu
mailingowi	mɛjˈlʲin.ɡɔˈvʲ.i
mailingowy	mɛj.lʲinˈɡɔ.vɨ
mailingowych	mɛj.lʲinˈɡɔ.vɨx
mailingowym	mɛj.lʲinˈɡɔ.vɨm
mailingowymi	mɛj.lʲinˈɡɔ.vɨˈmʲ.i
mailingu	mɛjˈlʲin.ɡu
mailom	ˈmɛj.lɔm
mailów	ˈmɛj.luf
mailować	mɛjˈlɔ.vat͡ɕ
mailował	mɛjˈlɔ.vaw
mailowała	mɛj.lɔˈva.wa
mailowałaby	mɛj.lɔ.vaˈwa.bɨ
mailowałabym	mɛj.lɔ.vaˈwa.bɨm
mailowałabyś	mɛj.lɔ.vaˈwa.bɨɕ
mailowałam	mɛj.lɔˈva.wam
mailowałaś	mɛj.lɔˈva.waɕ
mailowałby	mɛj.lɔˈvaw.bɨ
mailowałbym	mɛj.lɔˈvaw.bɨm
mailowałbyś	mɛj.lɔˈvaw.bɨɕ
mailowałem	mɛj.lɔˈva.wɛm
mailowałeś	mɛj.lɔˈva.wɛɕ
mailowali	mɛjˈlɔ.vaˈlʲ.i
mailowaliby	mɛj.lɔ.vaˈlʲi.bɨ
mailowalibyście	mɛj.lɔ.va.lʲiˈbɨɕ.t͡ɕɛ
mailowalibyśmy	mɛj.lɔ.va.lʲiˈbɨɕ.mɨ
mailowaliście	mɛj.lɔ.vaˈlʲiɕ.t͡ɕɛ
mailowaliśmy	mɛj.lɔ.vaˈlʲiɕ.mɨ
mailowało	mɛj.lɔˈva.wɔ
mailowałoby	mɛj.lɔ.vaˈwɔ.bɨ
mailowały	mɛj.lɔˈva.wɨ
mailowałyby	mɛj.lɔ.vaˈwɨ.bɨ
mailowałybyście	mɛj.lɔ.va.wɨˈbɨɕ.t͡ɕɛ
mailowałybyśmy	mɛj.lɔ.va.wɨˈbɨɕ.mɨ
mailowałyście	mɛj.lɔ.vaˈwɨɕ.t͡ɕɛ
mailowałyśmy	mɛj.lɔ.vaˈwɨɕ.mɨ
mailowań	mɛjˈlɔ.vaɲ
mailowana	mɛj.lɔˈva.na
mailowaną	mɛj.lɔˈva.nɔ̃
mailowane	mɛj.lɔˈva.nɛ
mailowanego	mɛj.lɔ.vaˈnɛ.ɡɔ
mailowanej	mɛj.lɔˈva.nɛj
mailowanemu	mɛj.lɔ.vaˈnɛ.mu
mailowani	mɛjˈlɔ.vaˈɲ.i
mailowania	mɛj.lɔˈva.ɲa
mailowaniach	mɛj.lɔˈva.ɲax
mailowaniami	mɛj.lɔˈva.ɲaˈmʲ.i
mailowanie	mɛj.lɔˈva.ɲɛ
mailowaniem	mɛj.lɔˈva.ɲɛm
mailowaniom	mɛj.lɔˈva.ɲɔm
mailowaniu	mɛj.lɔˈva.ɲu
mailowano	mɛj.lɔˈva.nɔ
mailowany	mɛj.lɔˈva.nɨ
mailowanych	mɛj.lɔˈva.nɨx
mailowanym	mɛj.lɔˈva.nɨm
mailowanymi	mɛj.lɔˈva.nɨˈmʲ.i
mailowi	ˈmɛj.lɔˈvʲ.i
mailu	ˈmɛj.lu
mailuj	ˈmɛj.luj
mailują	mɛjˈlu.jɔ̃
mailując	mɛjˈlu.jɔnt͡s
mailująca	mɛj.luˈjɔn.t͡sa
mailującą	mɛj.luˈjɔn.t͡sɔ̃
mailujące	mɛj.luˈjɔn.t͡sɛ
mailującego	mɛj.lu.jɔnˈt͡sɛ.ɡɔ
mailującej	mɛj.luˈjɔn.t͡sɛj
mailującemu	mɛj.lu.jɔnˈt͡sɛ.mu
mailujący	mɛj.luˈjɔn.t͡sɨ
mailujących	mɛj.luˈjɔn.t͡sɨx
mailującym	mɛj.luˈjɔn.t͡sɨm
mailującymi	mɛj.luˈjɔn.t͡sɨˈmʲ.i
mailujcie	mɛjˈluj.t͡ɕɛ
mailujcież	mɛjˈluj.t͡ɕɛʂ
mailuje	mɛjˈlu.jɛ
mailuję	mɛjˈlu.jɛ
mailujecie	mɛj.luˈjɛ.t͡ɕɛ
mailujemy	mɛj.luˈjɛ.mɨ
mailujesz	mɛjˈlu.jɛʂ
mailujmy	mɛjˈluj.mɨ
mailujmyż	mɛjˈluj.mɨʂ
mailujże	mɛjˈluj.ʐɛ
mainstream	ˈmɛj.nstrʲim
mainstreamach	mɛjˈnstrʲi.max
mainstreamami	mɛjˈnstrʲi.maˈmʲ.i
mainstreamem	mɛjˈnstrʲi.mɛm
mainstreamie	mɛjˈnstrʲi.mʲɛ
mainstreamom	mɛjˈnstrʲi.mɔm
mainstreamów	mɛjˈnstrʲi.muf
mainstreamowa	mɛj.nstrʲiˈmɔ.va
mainstreamową	mɛj.nstrʲiˈmɔ.vɔ̃
mainstreamowe	mɛj.nstrʲiˈmɔ.vɛ
mainstreamowego	mɛj.nstrʲi.mɔˈvɛ.ɡɔ
mainstreamowej	mɛj.nstrʲiˈmɔ.vɛj
mainstreamowemu	mɛj.nstrʲi.mɔˈvɛ.mu
mainstreamowi	mɛjˈnstrʲi.mɔˈvʲ.i
mainstreamowo	mɛj.nstrʲiˈmɔ.vɔ
mainstreamowy	mɛj.nstrʲiˈmɔ.vɨ
mainstreamowych	mɛj.nstrʲiˈmɔ.vɨx
mainstreamowym	mɛj.nstrʲiˈmɔ.vɨm
mainstreamowymi	mɛj.nstrʲiˈmɔ.vɨˈmʲ.i
mainstreamu	mɛjˈnstrʲi.mu
mainstreamy	mɛjˈnstrʲi.mɨ
Malaquais	maˈla.kɛ
Manchy	ˈman.t͡ʂɨ
Manerville	maˈnɛr.vʲil
Manon	ˈma.nu
Marcel	ˈmar.sɛl
Marcela	marˈsɛ.la
Marsaya	maˈra.ja
Mary	ˈmɛ.jrɨ
marzł	marzw
marzła	ˈmar.zwa
marzli	marsˈlʲ.i
marzło	ˈmar.zwɔ
marzły	ˈmar.zwɨ
marzną	ˈmar.znɔ̃
marznąć	ˈmar.znɔɲt͡ɕ
marznąc	ˈmar.znɔnt͡s
marznąca	marˈznɔn.t͡sa
marznącą	marˈznɔn.t͡sɔ̃
marznące	marˈznɔn.t͡sɛ
marznącego	mar.znɔnˈt͡sɛ.ɡɔ
marznącej	marˈznɔn.t͡sɛj
marznącemu	mar.znɔnˈt͡sɛ.mu
marznący	marˈznɔn.t͡sɨ
marznących	marˈznɔn.t͡sɨx
marznącym	marˈznɔn.t͡sɨm
marznącymi	marˈznɔn.t͡sɨˈmʲ.i
marznę	ˈmar.znɛ
marznie	ˈmar.zɲɛ
marznięcia	marˈzɲɛɲ.t͡ɕa
marzniecie	marˈzɲɛ.t͡ɕɛ
marznięcie	marˈzɲɛɲ.t͡ɕɛ
marznięciem	marˈzɲɛɲ.t͡ɕɛm
marznięciu	marˈzɲɛɲ.t͡ɕu
marzniemy	marˈzɲɛ.mɨ
marzniesz	ˈmar.zɲɛʂ
marznięto	marˈzɲɛn.tɔ
marznij	ˈmar.zɲij
marznijcie	marˈzɲij.t͡ɕɛ
marznijmy	marˈzɲij.mɨ
Maupin	ˈmu.pɔ̃
Mavericków	ma.vɛˈrʲi.kuf
maxi-singel	mak.siˈsin.ɡɛl
maxi-singiel	mak.siˈsin.ɡʲɛl
maxi-singla	mak.siˈsin.ɡla
maxi-singlach	mak.siˈsin.ɡlax
maxi-singlami	mak.siˈsin.ɡlaˈmʲ.i
maxi-single	mak.siˈsin.ɡlɛ
maxi-singlem	mak.siˈsin.ɡlɛm
maxi-singli	makˈsi.sinkˈlʲ.i
maxi-singlom	mak.siˈsin.ɡlɔm
maxi-singlów	mak.siˈsin.ɡluf
maxi-singlowi	mak.siˈsin.ɡlɔˈvʲ.i
maxi-singlu	mak.siˈsin.ɡlu
May	maj
may	mɛj
May	mɛj
Maya	ˈma.ja
Maya	ˈmɛ.ja
Mayach	ˈma.jax
Mayach	ˈmɛ.jax
Mayami	ˈma.jaˈmʲ.i
Mayami	ˈmɛ.jaˈmʲ.i
Mayami	mɛˈja.mʲi
Maye	ˈma.jɛ
Maye	ˈmɛ.jɛ
Mayem	ˈma.jɛm
Mayem	ˈmɛ.jɛm
Mayom	ˈma.jɔm
Mayom	ˈmɛ.jɔm
Mayów	ˈma.juf
Mayów	ˈmɛ.juf
Mayowi	ˈma.jɔˈvʲ.i
Mayowi	ˈmɛ.jɔˈvʲ.i
Mayowi	mɛˈjɔ.vʲi
Mayowie	maˈjɔ.vʲɛ
Mayowie	mɛˈjɔ.vʲɛ
Mayu	ˈma.ju
Mayu	ˈmɛ.ju
menu	ˈmɛ.ɲi
Merry	ˈmɛ.rɨ
Merry'ego	mɛˈrɛ.ɡɔ
Meyerbeera	ma.jɛrˈbɛ.ra
Meyrink	ˈmɛj.rʲink
M'Graw	mɡraw
Microsofcie	maj.krɔˈsɔf.t͡ɕɛ
Microsofcie	maj.krɔwˈsɔf.t͡ɕɛ
Microsoft	majˈkrɔ.sɔft
Microsoft	majˈkrɔw.sɔft
Microsoftem	maj.krɔˈsɔf.tɛm
Microsoftem	maj.krɔwˈsɔf.tɛm
microsoftowa	maj.krɔ.sɔfˈtɔ.va
microsoftową	maj.krɔ.sɔfˈtɔ.vɔ̃
microsoftowa	maj.krɔw.sɔfˈtɔ.va
microsoftową	maj.krɔw.sɔfˈtɔ.vɔ̃
microsoftowe	maj.krɔ.sɔfˈtɔ.vɛ
microsoftowe	maj.krɔw.sɔfˈtɔ.vɛ
microsoftowego	maj.krɔ.sɔf.tɔˈvɛ.ɡɔ
microsoftowego	maj.krɔw.sɔf.tɔˈvɛ.ɡɔ
microsoftowej	maj.krɔ.sɔfˈtɔ.vɛj
microsoftowej	maj.krɔw.sɔfˈtɔ.vɛj
microsoftowemu	maj.krɔ.sɔf.tɔˈvɛ.mu
microsoftowemu	maj.krɔw.sɔf.tɔˈvɛ.mu
microsoftowi	maj.krɔˈsɔf.tɔˈvʲ.i
Microsoftowi	maj.krɔˈsɔf.tɔˈvʲ.i
Microsoftowi	maj.krɔw.sɔfˈtɔ.vʲi
microsoftowi	maj.krɔwˈsɔf.tɔˈvʲ.i
Microsoftowi	maj.krɔwˈsɔf.tɔˈvʲ.i
microsoftowy	maj.krɔ.sɔfˈtɔ.vɨ
microsoftowy	maj.krɔw.sɔfˈtɔ.vɨ
microsoftowych	maj.krɔ.sɔfˈtɔ.vɨx
microsoftowych	maj.krɔw.sɔfˈtɔ.vɨx
microsoftowym	maj.krɔ.sɔfˈtɔ.vɨm
microsoftowym	maj.krɔw.sɔfˈtɔ.vɨm
microsoftowymi	maj.krɔ.sɔfˈtɔ.vɨˈmʲ.i
microsoftowymi	maj.krɔw.sɔfˈtɔ.vɨˈmʲ.i
Microsoftu	maj.krɔˈsɔf.tu
Microsoftu	maj.krɔwˈsɔf.tu
Miguel	ˈmʲi.ɡɛl
Milady	mʲiˈlɛj.di
Missouri	ˈmʲi.zuˈrʲ.i
Missouri	mʲiˈzu.rʲi
Modene	ˈmɔ.dɛn
moderne	ˈmɔ.dɛrn
Molière	ˈmɔ.lʲɛr
Moncornet	mɔnˈkɔr.nɛt
Monnier	ˈmɔ.ɲɛ
Monrose'a	mɔˈnrɔ.sa
Monseigneur	mɔnˈsɛ.ɲɛr
Monvelowi	mɔn.vɛˈlɔ.vʲi
Mufferson	maˈfɛr.sɔn
Mühlbruńskich	mɛlˈbruɲ.skʲix
Mundsleya	manˈtslɛ.ja
Musset	ˈmʲi.sɛt
nadmarzł	ˈnad.marzw
nadmarzła	nadˈmar.zwa
nadmarzli	ˈnad.marsˈlʲ.i
nadmarzło	nadˈmar.zwɔ
nadmarzłszy	nadˈmar.zwʂɨ
nadmarzły	nadˈmar.zwɨ
nadmarzną	nadˈmar.znɔ̃
nadmarznąć	nadˈmar.znɔɲt͡ɕ
nadmarznę	nadˈmar.znɛ
nadmarznie	nadˈmar.zɲɛ
nadmarznięci	nadˈmar.zɲɛˈt͡ɕ.i
nadmarznięcia	nad.marˈzɲɛɲ.t͡ɕa
nadmarzniecie	nad.marˈzɲɛ.t͡ɕɛ
nadmarznięcie	nad.marˈzɲɛɲ.t͡ɕɛ
nadmarznięciem	nad.marˈzɲɛɲ.t͡ɕɛm
nadmarznięciu	nad.marˈzɲɛɲ.t͡ɕu
nadmarzniemy	nad.marˈzɲɛ.mɨ
nadmarzniesz	nadˈmar.zɲɛʂ
nadmarznięta	nad.marˈzɲɛn.ta
nadmarzniętą	nad.marˈzɲɛn.tɔ̃
nadmarznięte	nad.marˈzɲɛn.tɛ
nadmarzniętego	nad.mar.zɲɛnˈtɛ.ɡɔ
nadmarzniętej	nad.marˈzɲɛn.tɛj
nadmarzniętemu	nad.mar.zɲɛnˈtɛ.mu
nadmarznięto	nad.marˈzɲɛn.tɔ
nadmarznięty	nad.marˈzɲɛn.tɨ
nadmarzniętych	nad.marˈzɲɛn.tɨx
nadmarzniętym	nad.marˈzɲɛn.tɨm
nadmarzniętymi	nad.marˈzɲɛn.tɨˈmʲ.i
nadmarznij	nadˈmar.zɲij
nadmarznijcie	nad.marˈzɲij.t͡ɕɛ
nadmarznijmy	nad.marˈzɲij.mɨ
namarzł	ˈna.marzw
namarzła	naˈmar.zwa
namarzli	ˈna.marsˈlʲ.i
namarzło	naˈmar.zwɔ
namarzłszy	naˈmar.zwʂɨ
namarzły	naˈmar.zwɨ
namarzną	naˈmar.znɔ̃
namarznąć	naˈmar.znɔɲt͡ɕ
namarznę	naˈmar.znɛ
namarznie	naˈmar.zɲɛ
namarznięci	naˈmar.zɲɛˈt͡ɕ.i
namarznięcia	na.marˈzɲɛɲ.t͡ɕa
namarzniecie	na.marˈzɲɛ.t͡ɕɛ
namarznięcie	na.marˈzɲɛɲ.t͡ɕɛ
namarznięciem	na.marˈzɲɛɲ.t͡ɕɛm
namarznięciu	na.marˈzɲɛɲ.t͡ɕu
namarzniemy	na.marˈzɲɛ.mɨ
namarzniesz	naˈmar.zɲɛʂ
namarznięta	na.marˈzɲɛn.ta
namarzniętą	na.marˈzɲɛn.tɔ̃
namarznięte	na.marˈzɲɛn.tɛ
namarzniętego	na.mar.zɲɛnˈtɛ.ɡɔ
namarzniętej	na.marˈzɲɛn.tɛj
namarzniętemu	na.mar.zɲɛnˈtɛ.mu
namarznięto	na.marˈzɲɛn.tɔ
namarznięty	na.marˈzɲɛn.tɨ
namarzniętych	na.marˈzɲɛn.tɨx
namarzniętym	na.marˈzɲɛn.tɨm
namarzniętymi	na.marˈzɲɛn.tɨˈmʲ.i
namarznij	naˈmar.zɲij
namarznijcie	na.marˈzɲij.t͡ɕɛ
namarznijmy	na.marˈzɲij.mɨ
Nathanael	na.taˈna.ɛl
Nathanaela	na.ta.naˈɛ.la
Navailles	ˈna.vajl
Navarreins	naˈva.rɛn
Necker	ˈnɛ.kɛr
Nefchâtel	nɛfˈʂa.tɛl
newsletter	ɲusˈlɛ.tɛr
newslettera	ɲus.lɛˈtɛ.ra
newsletterach	ɲus.lɛˈtɛ.rax
newsletterami	ɲus.lɛˈtɛ.raˈmʲ.i
newsletterem	ɲus.lɛˈtɛ.rɛm
newsletterom	ɲus.lɛˈtɛ.rɔm
newsletterów	ɲus.lɛˈtɛ.ruf
newsletterowa	ɲus.lɛ.tɛˈrɔ.va
newsletterową	ɲus.lɛ.tɛˈrɔ.vɔ̃
newsletterowe	ɲus.lɛ.tɛˈrɔ.vɛ
newsletterowego	ɲus.lɛ.tɛ.rɔˈvɛ.ɡɔ
newsletterowej	ɲus.lɛ.tɛˈrɔ.vɛj
newsletterowemu	ɲus.lɛ.tɛ.rɔˈvɛ.mu
newsletterowi	ɲus.lɛˈtɛ.rɔˈvʲ.i
newsletterowy	ɲus.lɛ.tɛˈrɔ.vɨ
newsletterowych	ɲus.lɛ.tɛˈrɔ.vɨx
newsletterowym	ɲus.lɛ.tɛˈrɔ.vɨm
newsletterowymi	ɲus.lɛ.tɛˈrɔ.vɨˈmʲ.i
newslettery	ɲus.lɛˈtɛ.rɨ
newsletterze	ɲus.lɛˈtɛ.ʐɛ
nick	ɲik
nicka	ˈɲi.ka
nickach	ˈɲi.kax
nickami	ˈɲi.kaˈmʲ.i
nicki	ɲiˈkʲ.i
nickiem	ˈɲi.kʲɛm
nickom	ˈɲi.kɔm
nicków	ˈɲi.kuf
nickowi	ˈɲi.kɔˈvʲ.i
nicku	ˈɲi.ku
nieaaronowa	ɲɛ.a.rɔˈnɔ.va
nieaaronową	ɲɛ.a.rɔˈnɔ.vɔ̃
nieaaronowe	ɲɛ.a.rɔˈnɔ.vɛ
nieaaronowego	ɲɛ.a.rɔ.nɔˈvɛ.ɡɔ
nieaaronowej	ɲɛ.a.rɔˈnɔ.vɛj
nieaaronowemu	ɲɛ.a.rɔ.nɔˈvɛ.mu
nieaaronowi	ɲɛ.aˈrɔ.nɔˈvʲ.i
nieaaronowy	ɲɛ.a.rɔˈnɔ.vɨ
nieaaronowych	ɲɛ.a.rɔˈnɔ.vɨx
nieaaronowym	ɲɛ.a.rɔˈnɔ.vɨm
nieaaronowymi	ɲɛ.a.rɔˈnɔ.vɨˈmʲ.i
niechopinowscy	ɲɛ.ʂɔ.pɛˈnɔf.st͡sɨ
niechopinowska	ɲɛ.ʂɔ.pɛˈnɔf.ska
niechopinowską	ɲɛ.ʂɔ.pɛˈnɔf.skɔ̃
niechopinowski	ɲɛ.ʂɔˈpɛ.nɔfsˈkʲ.i
niechopinowskich	ɲɛ.ʂɔ.pɛˈnɔf.skʲix
niechopinowskie	ɲɛ.ʂɔ.pɛˈnɔf.skʲɛ
niechopinowskiego	ɲɛ.ʂɔ.pɛ.nɔfˈskʲɛ.ɡɔ
niechopinowskiej	ɲɛ.ʂɔ.pɛˈnɔf.skʲɛj
niechopinowskiemu	ɲɛ.ʂɔ.pɛ.nɔfˈskʲɛ.mu
niechopinowskim	ɲɛ.ʂɔ.pɛˈnɔf.skʲim
niechopinowskimi	ɲɛ.ʂɔ.pɛˈnɔf.skʲiˈmʲ.i
niechopinowsko	ɲɛ.ʂɔ.pɛˈnɔf.skɔ
niedealerscy	ɲɛ.diˈlɛr.st͡sɨ
niedealerska	ɲɛ.diˈlɛr.ska
niedealerską	ɲɛ.diˈlɛr.skɔ̃
niedealerski	ɲɛˈdi.lɛrsˈkʲ.i
niedealerskich	ɲɛ.diˈlɛr.skʲix
niedealerskie	ɲɛ.diˈlɛr.skʲɛ
niedealerskiego	ɲɛ.di.lɛrˈskʲɛ.ɡɔ
niedealerskiej	ɲɛ.diˈlɛr.skʲɛj
niedealerskiemu	ɲɛ.di.lɛrˈskʲɛ.mu
niedealerskim	ɲɛ.diˈlɛr.skʲim
niedealerskimi	ɲɛ.diˈlɛr.skʲiˈmʲ.i
niedealersko	ɲɛ.diˈlɛr.skɔ
niedomarznięci	ɲɛ.dɔˈmar.zɲɛˈt͡ɕ.i
niedomarznięcia	ɲɛ.dɔ.marˈzɲɛɲ.t͡ɕa
niedomarznięcie	ɲɛ.dɔ.marˈzɲɛɲ.t͡ɕɛ
niedomarznięciem	ɲɛ.dɔ.marˈzɲɛɲ.t͡ɕɛm
niedomarznięciu	ɲɛ.dɔ.marˈzɲɛɲ.t͡ɕu
niedomarznięta	ɲɛ.dɔ.marˈzɲɛn.ta
niedomarzniętą	ɲɛ.dɔ.marˈzɲɛn.tɔ̃
niedomarznięte	ɲɛ.dɔ.marˈzɲɛn.tɛ
niedomarzniętego	ɲɛ.dɔ.mar.zɲɛnˈtɛ.ɡɔ
niedomarzniętej	ɲɛ.dɔ.marˈzɲɛn.tɛj
niedomarzniętemu	ɲɛ.dɔ.mar.zɲɛnˈtɛ.mu
niedomarznięty	ɲɛ.dɔ.marˈzɲɛn.tɨ
niedomarzniętych	ɲɛ.dɔ.marˈzɲɛn.tɨx
niedomarzniętym	ɲɛ.dɔ.marˈzɲɛn.tɨm
niedomarzniętymi	ɲɛ.dɔ.marˈzɲɛn.tɨˈmʲ.i
niegoethowscy	ɲɛ.ɡɛˈtɔf.st͡sɨ
niegoethowska	ɲɛ.ɡɛˈtɔf.ska
niegoethowską	ɲɛ.ɡɛˈtɔf.skɔ̃
niegoethowski	ɲɛˈɡɛ.tɔfsˈkʲ.i
niegoethowskich	ɲɛ.ɡɛˈtɔf.skʲix
niegoethowskie	ɲɛ.ɡɛˈtɔf.skʲɛ
niegoethowskiego	ɲɛ.ɡɛ.tɔfˈskʲɛ.ɡɔ
niegoethowskiej	ɲɛ.ɡɛˈtɔf.skʲɛj
niegoethowskiemu	ɲɛ.ɡɛ.tɔfˈskʲɛ.mu
niegoethowskim	ɲɛ.ɡɛˈtɔf.skʲim
niegoethowskimi	ɲɛ.ɡɛˈtɔf.skʲiˈmʲ.i
niegoethowsko	ɲɛ.ɡɛˈtɔf.skɔ
niehardcore'owa	ɲɛ.xar.tkɔˈrɔ.va
niehardcore'ową	ɲɛ.xar.tkɔˈrɔ.vɔ̃
niehardcore'owe	ɲɛ.xar.tkɔˈrɔ.vɛ
niehardcore'owego	ɲɛ.xar.tkɔ.rɔˈvɛ.ɡɔ
niehardcore'owej	ɲɛ.xar.tkɔˈrɔ.vɛj
niehardcore'owemu	ɲɛ.xar.tkɔ.rɔˈvɛ.mu
niehardcore'owi	ɲɛ.xarˈtkɔ.rɔˈvʲ.i
niehardcore'owo	ɲɛ.xar.tkɔˈrɔ.vɔ
niehardcore'owy	ɲɛ.xar.tkɔˈrɔ.vɨ
niehardcore'owych	ɲɛ.xar.tkɔˈrɔ.vɨx
niehardcore'owym	ɲɛ.xar.tkɔˈrɔ.vɨm
niehardcore'owymi	ɲɛ.xar.tkɔˈrɔ.vɨˈmʲ.i
nieleasingowań	ɲɛ.lʲi.zinˈɡɔ.vaɲ
nieleasingowana	ɲɛ.lʲi.zin.ɡɔˈva.na
nieleasingowaną	ɲɛ.lʲi.zin.ɡɔˈva.nɔ̃
nieleasingowane	ɲɛ.lʲi.zin.ɡɔˈva.nɛ
nieleasingowanego	ɲɛ.lʲi.zin.ɡɔ.vaˈnɛ.ɡɔ
nieleasingowanej	ɲɛ.lʲi.zin.ɡɔˈva.nɛj
nieleasingowanemu	ɲɛ.lʲi.zin.ɡɔ.vaˈnɛ.mu
nieleasingowani	ɲɛ.lʲi.zinˈɡɔ.vaˈɲ.i
nieleasingowania	ɲɛ.lʲi.zin.ɡɔˈva.ɲa
nieleasingowaniach	ɲɛ.lʲi.zin.ɡɔˈva.ɲax
nieleasingowaniami	ɲɛ.lʲi.zin.ɡɔˈva.ɲaˈmʲ.i
nieleasingowanie	ɲɛ.lʲi.zin.ɡɔˈva.ɲɛ
nieleasingowaniem	ɲɛ.lʲi.zin.ɡɔˈva.ɲɛm
nieleasingowaniom	ɲɛ.lʲi.zin.ɡɔˈva.ɲɔm
nieleasingowaniu	ɲɛ.lʲi.zin.ɡɔˈva.ɲu
nieleasingowany	ɲɛ.lʲi.zin.ɡɔˈva.nɨ
nieleasingowanych	ɲɛ.lʲi.zin.ɡɔˈva.nɨx
nieleasingowanym	ɲɛ.lʲi.zin.ɡɔˈva.nɨm
nieleasingowanymi	ɲɛ.lʲi.zin.ɡɔˈva.nɨˈmʲ.i
nieleasingująca	ɲɛ.lʲi.zin.ɡuˈjɔn.t͡sa
nieleasingującą	ɲɛ.lʲi.zin.ɡuˈjɔn.t͡sɔ̃
nieleasingujące	ɲɛ.lʲi.zin.ɡuˈjɔn.t͡sɛ
nieleasingującego	ɲɛ.lʲi.zin.ɡu.jɔnˈt͡sɛ.ɡɔ
nieleasingującej	ɲɛ.lʲi.zin.ɡuˈjɔn.t͡sɛj
nieleasingującemu	ɲɛ.lʲi.zin.ɡu.jɔnˈt͡sɛ.mu
nieleasingujący	ɲɛ.lʲi.zin.ɡuˈjɔn.t͡sɨ
nieleasingujących	ɲɛ.lʲi.zin.ɡuˈjɔn.t͡sɨx
nieleasingującym	ɲɛ.lʲi.zin.ɡuˈjɔn.t͡sɨm
nieleasingującymi	ɲɛ.lʲi.zin.ɡuˈjɔn.t͡sɨˈmʲ.i
niemailingowa	ɲɛ.mɛj.lʲinˈɡɔ.va
niemailingową	ɲɛ.mɛj.lʲinˈɡɔ.vɔ̃
niemailingowe	ɲɛ.mɛj.lʲinˈɡɔ.vɛ
niemailingowego	ɲɛ.mɛj.lʲin.ɡɔˈvɛ.ɡɔ
niemailingowej	ɲɛ.mɛj.lʲinˈɡɔ.vɛj
niemailingowemu	ɲɛ.mɛj.lʲin.ɡɔˈvɛ.mu
niemailingowi	ɲɛ.mɛjˈlʲin.ɡɔˈvʲ.i
niemailingowy	ɲɛ.mɛj.lʲinˈɡɔ.vɨ
niemailingowych	ɲɛ.mɛj.lʲinˈɡɔ.vɨx
niemailingowym	ɲɛ.mɛj.lʲinˈɡɔ.vɨm
niemailingowymi	ɲɛ.mɛj.lʲinˈɡɔ.vɨˈmʲ.i
niemailowań	ɲɛ.mɛjˈlɔ.vaɲ
niemailowana	ɲɛ.mɛj.lɔˈva.na
niemailowaną	ɲɛ.mɛj.lɔˈva.nɔ̃
niemailowane	ɲɛ.mɛj.lɔˈva.nɛ
niemailowanego	ɲɛ.mɛj.lɔ.vaˈnɛ.ɡɔ
niemailowanej	ɲɛ.mɛj.lɔˈva.nɛj
niemailowanemu	ɲɛ.mɛj.lɔ.vaˈnɛ.mu
niemailowani	ɲɛ.mɛjˈlɔ.vaˈɲ.i
niemailowania	ɲɛ.mɛj.lɔˈva.ɲa
niemailowaniach	ɲɛ.mɛj.lɔˈva.ɲax
niemailowaniami	ɲɛ.mɛj.lɔˈva.ɲaˈmʲ.i
niemailowanie	ɲɛ.mɛj.lɔˈva.ɲɛ
niemailowaniem	ɲɛ.mɛj.lɔˈva.ɲɛm
niemailowaniom	ɲɛ.mɛj.lɔˈva.ɲɔm
niemailowaniu	ɲɛ.mɛj.lɔˈva.ɲu
niemailowany	ɲɛ.mɛj.lɔˈva.nɨ
niemailowanych	ɲɛ.mɛj.lɔˈva.nɨx
niemailowanym	ɲɛ.mɛj.lɔˈva.nɨm
niemailowanymi	ɲɛ.mɛj.lɔˈva.nɨˈmʲ.i
niemailująca	ɲɛ.mɛj.luˈjɔn.t͡sa
niemailującą	ɲɛ.mɛj.luˈjɔn.t͡sɔ̃
niemailujące	ɲɛ.mɛj.luˈjɔn.t͡sɛ
niemailującego	ɲɛ.mɛj.lu.jɔnˈt͡sɛ.ɡɔ
niemailującej	ɲɛ.mɛj.luˈjɔn.t͡sɛj
niemailującemu	ɲɛ.mɛj.lu.jɔnˈt͡sɛ.mu
niemailujący	ɲɛ.mɛj.luˈjɔn.t͡sɨ
niemailujących	ɲɛ.mɛj.luˈjɔn.t͡sɨx
niemailującym	ɲɛ.mɛj.luˈjɔn.t͡sɨm
niemailującymi	ɲɛ.mɛj.luˈjɔn.t͡sɨˈmʲ.i
niemainstreamowa	ɲɛ.mɛj.nstrʲiˈmɔ.va
niemainstreamową	ɲɛ.mɛj.nstrʲiˈmɔ.vɔ̃
niemainstreamowe	ɲɛ.mɛj.nstrʲiˈmɔ.vɛ
niemainstreamowego	ɲɛ.mɛj.nstrʲi.mɔˈvɛ.ɡɔ
niemainstreamowej	ɲɛ.mɛj.nstrʲiˈmɔ.vɛj
niemainstreamowemu	ɲɛ.mɛj.nstrʲi.mɔˈvɛ.mu
niemainstreamowi	ɲɛ.mɛjˈnstrʲi.mɔˈvʲ.i
niemainstreamowo	ɲɛ.mɛj.nstrʲiˈmɔ.vɔ
niemainstreamowy	ɲɛ.mɛj.nstrʲiˈmɔ.vɨ
niemainstreamowych	ɲɛ.mɛj.nstrʲiˈmɔ.vɨx
niemainstreamowym	ɲɛ.mɛj.nstrʲiˈmɔ.vɨm
niemainstreamowymi	ɲɛ.mɛj.nstrʲiˈmɔ.vɨˈmʲ.i
niemarznąca	ɲɛ.marˈznɔn.t͡sa
niemarznącą	ɲɛ.marˈznɔn.t͡sɔ̃
niemarznące	ɲɛ.marˈznɔn.t͡sɛ
niemarznącego	ɲɛ.mar.znɔnˈt͡sɛ.ɡɔ
niemarznącej	ɲɛ.marˈznɔn.t͡sɛj
niemarznącemu	ɲɛ.mar.znɔnˈt͡sɛ.mu
niemarznący	ɲɛ.marˈznɔn.t͡sɨ
niemarznących	ɲɛ.marˈznɔn.t͡sɨx
niemarznącym	ɲɛ.marˈznɔn.t͡sɨm
niemarznącymi	ɲɛ.marˈznɔn.t͡sɨˈmʲ.i
niemarznięcia	ɲɛ.marˈzɲɛɲ.t͡ɕa
niemarznięcie	ɲɛ.marˈzɲɛɲ.t͡ɕɛ
niemarznięciem	ɲɛ.marˈzɲɛɲ.t͡ɕɛm
niemarznięciu	ɲɛ.marˈzɲɛɲ.t͡ɕu
niemicrosoftowa	ɲɛ.maj.krɔ.sɔfˈtɔ.va
niemicrosoftową	ɲɛ.maj.krɔ.sɔfˈtɔ.vɔ̃
niemicrosoftowa	ɲɛ.maj.krɔw.sɔfˈtɔ.va
niemicrosoftową	ɲɛ.maj.krɔw.sɔfˈtɔ.vɔ̃
niemicrosoftowe	ɲɛ.maj.krɔ.sɔfˈtɔ.vɛ
niemicrosoftowe	ɲɛ.maj.krɔw.sɔfˈtɔ.vɛ
niemicrosoftowego	ɲɛ.maj.krɔ.sɔf.tɔˈvɛ.ɡɔ
niemicrosoftowego	ɲɛ.maj.krɔw.sɔf.tɔˈvɛ.ɡɔ
niemicrosoftowej	ɲɛ.maj.krɔ.sɔfˈtɔ.vɛj
niemicrosoftowej	ɲɛ.maj.krɔw.sɔfˈtɔ.vɛj
niemicrosoftowemu	ɲɛ.maj.krɔ.sɔf.tɔˈvɛ.mu
niemicrosoftowemu	ɲɛ.maj.krɔw.sɔf.tɔˈvɛ.mu
niemicrosoftowi	ɲɛ.maj.krɔˈsɔf.tɔˈvʲ.i
niemicrosoftowi	ɲɛ.maj.krɔwˈsɔf.tɔˈvʲ.i
niemicrosoftowy	ɲɛ.maj.krɔ.sɔfˈtɔ.vɨ
niemicrosoftowy	ɲɛ.maj.krɔw.sɔfˈtɔ.vɨ
niemicrosoftowych	ɲɛ.maj.krɔ.sɔfˈtɔ.vɨx
niemicrosoftowych	ɲɛ.maj.krɔw.sɔfˈtɔ.vɨx
niemicrosoftowym	ɲɛ.maj.krɔ.sɔfˈtɔ.vɨm
niemicrosoftowym	ɲɛ.maj.krɔw.sɔfˈtɔ.vɨm
niemicrosoftowymi	ɲɛ.maj.krɔ.sɔfˈtɔ.vɨˈmʲ.i
niemicrosoftowymi	ɲɛ.maj.krɔw.sɔfˈtɔ.vɨˈmʲ.i
nienadmarznięci	ɲɛ.nadˈmar.zɲɛˈt͡ɕ.i
nienadmarznięcia	ɲɛ.nad.marˈzɲɛɲ.t͡ɕa
nienadmarznięcie	ɲɛ.nad.marˈzɲɛɲ.t͡ɕɛ
nienadmarznięciem	ɲɛ.nad.marˈzɲɛɲ.t͡ɕɛm
nienadmarznięciu	ɲɛ.nad.marˈzɲɛɲ.t͡ɕu
nienadmarznięta	ɲɛ.nad.marˈzɲɛn.ta
nienadmarzniętą	ɲɛ.nad.marˈzɲɛn.tɔ̃
nienadmarznięte	ɲɛ.nad.marˈzɲɛn.tɛ
nienadmarzniętego	ɲɛ.nad.mar.zɲɛnˈtɛ.ɡɔ
nienadmarzniętej	ɲɛ.nad.marˈzɲɛn.tɛj
nienadmarzniętemu	ɲɛ.nad.mar.zɲɛnˈtɛ.mu
nienadmarznięty	ɲɛ.nad.marˈzɲɛn.tɨ
nienadmarzniętych	ɲɛ.nad.marˈzɲɛn.tɨx
nienadmarzniętym	ɲɛ.nad.marˈzɲɛn.tɨm
nienadmarzniętymi	ɲɛ.nad.marˈzɲɛn.tɨˈmʲ.i
nienamarznięci	ɲɛ.naˈmar.zɲɛˈt͡ɕ.i
nienamarznięcia	ɲɛ.na.marˈzɲɛɲ.t͡ɕa
nienamarznięcie	ɲɛ.na.marˈzɲɛɲ.t͡ɕɛ
nienamarznięciem	ɲɛ.na.marˈzɲɛɲ.t͡ɕɛm
nienamarznięciu	ɲɛ.na.marˈzɲɛɲ.t͡ɕu
nienamarznięta	ɲɛ.na.marˈzɲɛn.ta
nienamarzniętą	ɲɛ.na.marˈzɲɛn.tɔ̃
nienamarznięte	ɲɛ.na.marˈzɲɛn.tɛ
nienamarzniętego	ɲɛ.na.mar.zɲɛnˈtɛ.ɡɔ
nienamarzniętej	ɲɛ.na.marˈzɲɛn.tɛj
nienamarzniętemu	ɲɛ.na.mar.zɲɛnˈtɛ.mu
nienamarznięty	ɲɛ.na.marˈzɲɛn.tɨ
nienamarzniętych	ɲɛ.na.marˈzɲɛn.tɨx
nienamarzniętym	ɲɛ.na.marˈzɲɛn.tɨm
nienamarzniętymi	ɲɛ.na.marˈzɲɛn.tɨˈmʲ.i
nienewsletterowa	ɲɛ.ɲus.lɛ.tɛˈrɔ.va
nienewsletterową	ɲɛ.ɲus.lɛ.tɛˈrɔ.vɔ̃
nienewsletterowe	ɲɛ.ɲus.lɛ.tɛˈrɔ.vɛ
nienewsletterowego	ɲɛ.ɲus.lɛ.tɛ.rɔˈvɛ.ɡɔ
nienewsletterowej	ɲɛ.ɲus.lɛ.tɛˈrɔ.vɛj
nienewsletterowemu	ɲɛ.ɲus.lɛ.tɛ.rɔˈvɛ.mu
nienewsletterowi	ɲɛ.ɲus.lɛˈtɛ.rɔˈvʲ.i
nienewsletterowy	ɲɛ.ɲus.lɛ.tɛˈrɔ.vɨ
nienewsletterowych	ɲɛ.ɲus.lɛ.tɛˈrɔ.vɨx
nienewsletterowym	ɲɛ.ɲus.lɛ.tɛˈrɔ.vɨm
nienewsletterowymi	ɲɛ.ɲus.lɛ.tɛˈrɔ.vɨˈmʲ.i
nieobmarznięci	ɲɛ.ɔbˈmar.zɲɛˈt͡ɕ.i
nieobmarznięcia	ɲɛ.ɔb.marˈzɲɛɲ.t͡ɕa
nieobmarznięcie	ɲɛ.ɔb.marˈzɲɛɲ.t͡ɕɛ
nieobmarznięciem	ɲɛ.ɔb.marˈzɲɛɲ.t͡ɕɛm
nieobmarznięciu	ɲɛ.ɔb.marˈzɲɛɲ.t͡ɕu
nieobmarznięta	ɲɛ.ɔb.marˈzɲɛn.ta
nieobmarzniętą	ɲɛ.ɔb.marˈzɲɛn.tɔ̃
nieobmarznięte	ɲɛ.ɔb.marˈzɲɛn.tɛ
nieobmarzniętego	ɲɛ.ɔb.mar.zɲɛnˈtɛ.ɡɔ
nieobmarzniętej	ɲɛ.ɔb.marˈzɲɛn.tɛj
nieobmarzniętemu	ɲɛ.ɔb.mar.zɲɛnˈtɛ.mu
nieobmarznięty	ɲɛ.ɔb.marˈzɲɛn.tɨ
nieobmarzniętych	ɲɛ.ɔb.marˈzɲɛn.tɨx
nieobmarzniętym	ɲɛ.ɔb.marˈzɲɛn.tɨm
nieobmarzniętymi	ɲɛ.ɔb.marˈzɲɛn.tɨˈmʲ.i
nieodmarznięci	ɲɛ.ɔdˈmar.zɲɛˈt͡ɕ.i
nieodmarznięcia	ɲɛ.ɔd.marˈzɲɛɲ.t͡ɕa
nieodmarznięcie	ɲɛ.ɔd.marˈzɲɛɲ.t͡ɕɛ
nieodmarznięciem	ɲɛ.ɔd.marˈzɲɛɲ.t͡ɕɛm
nieodmarznięciu	ɲɛ.ɔd.marˈzɲɛɲ.t͡ɕu
nieodmarznięta	ɲɛ.ɔd.marˈzɲɛn.ta
nieodmarzniętą	ɲɛ.ɔd.marˈzɲɛn.tɔ̃
nieodmarznięte	ɲɛ.ɔd.marˈzɲɛn.tɛ
nieodmarzniętego	ɲɛ.ɔd.mar.zɲɛnˈtɛ.ɡɔ
nieodmarzniętej	ɲɛ.ɔd.marˈzɲɛn.tɛj
nieodmarzniętemu	ɲɛ.ɔd.mar.zɲɛnˈtɛ.mu
nieodmarznięty	ɲɛ.ɔd.marˈzɲɛn.tɨ
nieodmarzniętych	ɲɛ.ɔd.marˈzɲɛn.tɨx
nieodmarzniętym	ɲɛ.ɔd.marˈzɲɛn.tɨm
nieodmarzniętymi	ɲɛ.ɔd.marˈzɲɛn.tɨˈmʲ.i
nieoffsetowa	ɲɛ.ɔf.sɛˈtɔ.va
nieoffsetową	ɲɛ.ɔf.sɛˈtɔ.vɔ̃
nieoffsetowe	ɲɛ.ɔf.sɛˈtɔ.vɛ
nieoffsetowego	ɲɛ.ɔf.sɛ.tɔˈvɛ.ɡɔ
nieoffsetowej	ɲɛ.ɔf.sɛˈtɔ.vɛj
nieoffsetowemu	ɲɛ.ɔf.sɛ.tɔˈvɛ.mu
nieoffsetowi	ɲɛ.ɔfˈsɛ.tɔˈvʲ.i
nieoffsetowy	ɲɛ.ɔf.sɛˈtɔ.vɨ
nieoffsetowych	ɲɛ.ɔf.sɛˈtɔ.vɨx
nieoffsetowym	ɲɛ.ɔf.sɛˈtɔ.vɨm
nieoffsetowymi	ɲɛ.ɔf.sɛˈtɔ.vɨˈmʲ.i
nieomarznięci	ɲɛ.ɔˈmar.zɲɛˈt͡ɕ.i
nieomarznięcia	ɲɛ.ɔ.marˈzɲɛɲ.t͡ɕa
nieomarznięcie	ɲɛ.ɔ.marˈzɲɛɲ.t͡ɕɛ
nieomarznięciem	ɲɛ.ɔ.marˈzɲɛɲ.t͡ɕɛm
nieomarznięciu	ɲɛ.ɔ.marˈzɲɛɲ.t͡ɕu
nieomarznięta	ɲɛ.ɔ.marˈzɲɛn.ta
nieomarzniętą	ɲɛ.ɔ.marˈzɲɛn.tɔ̃
nieomarznięte	ɲɛ.ɔ.marˈzɲɛn.tɛ
nieomarzniętego	ɲɛ.ɔ.mar.zɲɛnˈtɛ.ɡɔ
nieomarzniętej	ɲɛ.ɔ.marˈzɲɛn.tɛj
nieomarzniętemu	ɲɛ.ɔ.mar.zɲɛnˈtɛ.mu
nieomarznięty	ɲɛ.ɔ.marˈzɲɛn.tɨ
nieomarzniętych	ɲɛ.ɔ.marˈzɲɛn.tɨx
nieomarzniętym	ɲɛ.ɔ.marˈzɲɛn.tɨm
nieomarzniętymi	ɲɛ.ɔ.marˈzɲɛn.tɨˈmʲ.i
niepeerelowscy	ɲɛ.pɛ.ɛ.rɛˈlɔf.st͡sɨ
niepeerelowska	ɲɛ.pɛ.ɛ.rɛˈlɔf.ska
niepeerelowską	ɲɛ.pɛ.ɛ.rɛˈlɔf.skɔ̃
niepeerelowski	ɲɛ.pɛ.ɛˈrɛ.lɔfsˈkʲ.i
niepeerelowskich	ɲɛ.pɛ.ɛ.rɛˈlɔf.skʲix
niepeerelowskie	ɲɛ.pɛ.ɛ.rɛˈlɔf.skʲɛ
niepeerelowskiego	ɲɛ.pɛ.ɛ.rɛ.lɔfˈskʲɛ.ɡɔ
niepeerelowskiej	ɲɛ.pɛ.ɛ.rɛˈlɔf.skʲɛj
niepeerelowskiemu	ɲɛ.pɛ.ɛ.rɛ.lɔfˈskʲɛ.mu
niepeerelowskim	ɲɛ.pɛ.ɛ.rɛˈlɔf.skʲim
niepeerelowskimi	ɲɛ.pɛ.ɛ.rɛˈlɔf.skʲiˈmʲ.i
niepeerelowsko	ɲɛ.pɛ.ɛ.rɛˈlɔf.skɔ
niepeeselowscy	ɲɛ.pɛ.ɛ.sɛˈlɔf.st͡sɨ
niepeeselowska	ɲɛ.pɛ.ɛ.sɛˈlɔf.ska
niepeeselowską	ɲɛ.pɛ.ɛ.sɛˈlɔf.skɔ̃
niepeeselowski	ɲɛ.pɛ.ɛˈsɛ.lɔfsˈkʲ.i
niepeeselowskich	ɲɛ.pɛ.ɛ.sɛˈlɔf.skʲix
niepeeselowskie	ɲɛ.pɛ.ɛ.sɛˈlɔf.skʲɛ
niepeeselowskiego	ɲɛ.pɛ.ɛ.sɛ.lɔfˈskʲɛ.ɡɔ
niepeeselowskiej	ɲɛ.pɛ.ɛ.sɛˈlɔf.skʲɛj
niepeeselowskiemu	ɲɛ.pɛ.ɛ.sɛ.lɔfˈskʲɛ.mu
niepeeselowskim	ɲɛ.pɛ.ɛ.sɛˈlɔf.skʲim
niepeeselowskimi	ɲɛ.pɛ.ɛ.sɛˈlɔf.skʲiˈmʲ.i
niepeeselowsko	ɲɛ.pɛ.ɛ.sɛˈlɔf.skɔ
niepodmarznięci	ɲɛ.pɔdˈmar.zɲɛˈt͡ɕ.i
niepodmarznięcia	ɲɛ.pɔd.marˈzɲɛɲ.t͡ɕa
niepodmarznięcie	ɲɛ.pɔd.marˈzɲɛɲ.t͡ɕɛ
niepodmarznięciem	ɲɛ.pɔd.marˈzɲɛɲ.t͡ɕɛm
niepodmarznięciu	ɲɛ.pɔd.marˈzɲɛɲ.t͡ɕu
niepodmarznięta	ɲɛ.pɔd.marˈzɲɛn.ta
niepodmarzniętą	ɲɛ.pɔd.marˈzɲɛn.tɔ̃
niepodmarznięte	ɲɛ.pɔd.marˈzɲɛn.tɛ
niepodmarzniętego	ɲɛ.pɔd.mar.zɲɛnˈtɛ.ɡɔ
niepodmarzniętej	ɲɛ.pɔd.marˈzɲɛn.tɛj
niepodmarzniętemu	ɲɛ.pɔd.mar.zɲɛnˈtɛ.mu
niepodmarznięty	ɲɛ.pɔd.marˈzɲɛn.tɨ
niepodmarzniętych	ɲɛ.pɔd.marˈzɲɛn.tɨx
niepodmarzniętym	ɲɛ.pɔd.marˈzɲɛn.tɨm
niepodmarzniętymi	ɲɛ.pɔd.marˈzɲɛn.tɨˈmʲ.i
niepomarznięci	ɲɛ.pɔˈmar.zɲɛˈt͡ɕ.i
niepomarznięcia	ɲɛ.pɔ.marˈzɲɛɲ.t͡ɕa
niepomarznięcie	ɲɛ.pɔ.marˈzɲɛɲ.t͡ɕɛ
niepomarznięciem	ɲɛ.pɔ.marˈzɲɛɲ.t͡ɕɛm
niepomarznięciu	ɲɛ.pɔ.marˈzɲɛɲ.t͡ɕu
niepomarznięta	ɲɛ.pɔ.marˈzɲɛn.ta
niepomarzniętą	ɲɛ.pɔ.marˈzɲɛn.tɔ̃
niepomarznięte	ɲɛ.pɔ.marˈzɲɛn.tɛ
niepomarzniętego	ɲɛ.pɔ.mar.zɲɛnˈtɛ.ɡɔ
niepomarzniętej	ɲɛ.pɔ.marˈzɲɛn.tɛj
niepomarzniętemu	ɲɛ.pɔ.mar.zɲɛnˈtɛ.mu
niepomarznięty	ɲɛ.pɔ.marˈzɲɛn.tɨ
niepomarzniętych	ɲɛ.pɔ.marˈzɲɛn.tɨx
niepomarzniętym	ɲɛ.pɔ.marˈzɲɛn.tɨm
niepomarzniętymi	ɲɛ.pɔ.marˈzɲɛn.tɨˈmʲ.i
niepozamarzana	ɲɛ.pɔ.za.marˈza.na
niepozamarzaną	ɲɛ.pɔ.za.marˈza.nɔ̃
niepozamarzane	ɲɛ.pɔ.za.marˈza.nɛ
niepozamarzanego	ɲɛ.pɔ.za.mar.zaˈnɛ.ɡɔ
niepozamarzanej	ɲɛ.pɔ.za.marˈza.nɛj
niepozamarzanemu	ɲɛ.pɔ.za.mar.zaˈnɛ.mu
niepozamarzani	ɲɛ.pɔ.zaˈmar.zaˈɲ.i
niepozamarzania	ɲɛ.pɔ.za.marˈza.ɲa
niepozamarzanie	ɲɛ.pɔ.za.marˈza.ɲɛ
niepozamarzaniem	ɲɛ.pɔ.za.marˈza.ɲɛm
niepozamarzaniu	ɲɛ.pɔ.za.marˈza.ɲu
niepozamarzany	ɲɛ.pɔ.za.marˈza.nɨ
niepozamarzanych	ɲɛ.pɔ.za.marˈza.nɨx
niepozamarzanym	ɲɛ.pɔ.za.marˈza.nɨm
niepozamarzanymi	ɲɛ.pɔ.za.marˈza.nɨˈmʲ.i
nieprzemarznięci	ɲɛp.ʂɛˈmar.zɲɛˈt͡ɕ.i
nieprzemarznięcia	ɲɛp.ʂɛ.marˈzɲɛɲ.t͡ɕa
nieprzemarznięcie	ɲɛp.ʂɛ.marˈzɲɛɲ.t͡ɕɛ
nieprzemarznięciem	ɲɛp.ʂɛ.marˈzɲɛɲ.t͡ɕɛm
nieprzemarznięciu	ɲɛp.ʂɛ.marˈzɲɛɲ.t͡ɕu
nieprzemarznięta	ɲɛp.ʂɛ.marˈzɲɛn.ta
nieprzemarzniętą	ɲɛp.ʂɛ.marˈzɲɛn.tɔ̃
nieprzemarznięte	ɲɛp.ʂɛ.marˈzɲɛn.tɛ
nieprzemarzniętego	ɲɛp.ʂɛ.mar.zɲɛnˈtɛ.ɡɔ
nieprzemarzniętej	ɲɛp.ʂɛ.marˈzɲɛn.tɛj
nieprzemarzniętemu	ɲɛp.ʂɛ.mar.zɲɛnˈtɛ.mu
nieprzemarznięty	ɲɛp.ʂɛ.marˈzɲɛn.tɨ
nieprzemarzniętych	ɲɛp.ʂɛ.marˈzɲɛn.tɨx
nieprzemarzniętym	ɲɛp.ʂɛ.marˈzɲɛn.tɨm
nieprzemarzniętymi	ɲɛp.ʂɛ.marˈzɲɛn.tɨˈmʲ.i
nieprzymarznięci	ɲɛp.ʂɨˈmar.zɲɛˈt͡ɕ.i
nieprzymarznięcia	ɲɛp.ʂɨ.marˈzɲɛɲ.t͡ɕa
nieprzymarznięcie	ɲɛp.ʂɨ.marˈzɲɛɲ.t͡ɕɛ
nieprzymarznięciem	ɲɛp.ʂɨ.marˈzɲɛɲ.t͡ɕɛm
nieprzymarznięciu	ɲɛp.ʂɨ.marˈzɲɛɲ.t͡ɕu
nieprzymarznięta	ɲɛp.ʂɨ.marˈzɲɛn.ta
nieprzymarzniętą	ɲɛp.ʂɨ.marˈzɲɛn.tɔ̃
nieprzymarznięte	ɲɛp.ʂɨ.marˈzɲɛn.tɛ
nieprzymarzniętego	ɲɛp.ʂɨ.mar.zɲɛnˈtɛ.ɡɔ
nieprzymarzniętej	ɲɛp.ʂɨ.marˈzɲɛn.tɛj
nieprzymarzniętemu	ɲɛp.ʂɨ.mar.zɲɛnˈtɛ.mu
nieprzymarznięty	ɲɛp.ʂɨ.marˈzɲɛn.tɨ
nieprzymarzniętych	ɲɛp.ʂɨ.marˈzɲɛn.tɨx
nieprzymarzniętym	ɲɛp.ʂɨ.marˈzɲɛn.tɨm
nieprzymarzniętymi	ɲɛp.ʂɨ.marˈzɲɛn.tɨˈmʲ.i
nierozmarznięci	ɲɛ.rɔzˈmar.zɲɛˈt͡ɕ.i
nierozmarznięcia	ɲɛ.rɔz.marˈzɲɛɲ.t͡ɕa
nierozmarznięcie	ɲɛ.rɔz.marˈzɲɛɲ.t͡ɕɛ
nierozmarznięciem	ɲɛ.rɔz.marˈzɲɛɲ.t͡ɕɛm
nierozmarznięciu	ɲɛ.rɔz.marˈzɲɛɲ.t͡ɕu
nierozmarznięta	ɲɛ.rɔz.marˈzɲɛn.ta
nierozmarzniętą	ɲɛ.rɔz.marˈzɲɛn.tɔ̃
nierozmarznięte	ɲɛ.rɔz.marˈzɲɛn.tɛ
nierozmarzniętego	ɲɛ.rɔz.mar.zɲɛnˈtɛ.ɡɔ
nierozmarzniętej	ɲɛ.rɔz.marˈzɲɛn.tɛj
nierozmarzniętemu	ɲɛ.rɔz.mar.zɲɛnˈtɛ.mu
nierozmarznięty	ɲɛ.rɔz.marˈzɲɛn.tɨ
nierozmarzniętych	ɲɛ.rɔz.marˈzɲɛn.tɨx
nierozmarzniętym	ɲɛ.rɔz.marˈzɲɛn.tɨm
nierozmarzniętymi	ɲɛ.rɔz.marˈzɲɛn.tɨˈmʲ.i
niesinusoidalna	ɲɛ.si.nu.sɔjˈdal.na
niesinusoidalną	ɲɛ.si.nu.sɔjˈdal.nɔ̃
niesinusoidalne	ɲɛ.si.nu.sɔjˈdal.nɛ
niesinusoidalnego	ɲɛ.si.nu.sɔj.dalˈnɛ.ɡɔ
niesinusoidalnej	ɲɛ.si.nu.sɔjˈdal.nɛj
niesinusoidalnemu	ɲɛ.si.nu.sɔj.dalˈnɛ.mu
niesinusoidalni	ɲɛ.si.nuˈsɔj.dalˈɲ.i
niesinusoidalnie	ɲɛ.si.nu.sɔjˈdal.ɲɛ
niesinusoidalny	ɲɛ.si.nu.sɔjˈdal.nɨ
niesinusoidalnych	ɲɛ.si.nu.sɔjˈdal.nɨx
niesinusoidalnym	ɲɛ.si.nu.sɔjˈdal.nɨm
niesinusoidalnymi	ɲɛ.si.nu.sɔjˈdal.nɨˈmʲ.i
nieumarznięci	ɲɛ.uˈmar.zɲɛˈt͡ɕ.i
nieumarznięcia	ɲɛ.u.marˈzɲɛɲ.t͡ɕa
nieumarznięcie	ɲɛ.u.marˈzɲɛɲ.t͡ɕɛ
nieumarznięciem	ɲɛ.u.marˈzɲɛɲ.t͡ɕɛm
nieumarznięciu	ɲɛ.u.marˈzɲɛɲ.t͡ɕu
nieumarznięta	ɲɛ.u.marˈzɲɛn.ta
nieumarzniętą	ɲɛ.u.marˈzɲɛn.tɔ̃
nieumarznięte	ɲɛ.u.marˈzɲɛn.tɛ
nieumarzniętego	ɲɛ.u.mar.zɲɛnˈtɛ.ɡɔ
nieumarzniętej	ɲɛ.u.marˈzɲɛn.tɛj
nieumarzniętemu	ɲɛ.u.mar.zɲɛnˈtɛ.mu
nieumarznięty	ɲɛ.u.marˈzɲɛn.tɨ
nieumarzniętych	ɲɛ.u.marˈzɲɛn.tɨx
nieumarzniętym	ɲɛ.u.marˈzɲɛn.tɨm
nieumarzniętymi	ɲɛ.u.marˈzɲɛn.tɨˈmʲ.i
niewindowsowa	ɲɛ.win.dɔwˈsɔ.va
niewindowsową	ɲɛ.win.dɔwˈsɔ.vɔ̃
niewindowsowe	ɲɛ.win.dɔwˈsɔ.vɛ
niewindowsowego	ɲɛ.win.dɔw.sɔˈvɛ.ɡɔ
niewindowsowej	ɲɛ.win.dɔwˈsɔ.vɛj
niewindowsowemu	ɲɛ.win.dɔw.sɔˈvɛ.mu
niewindowsowi	ɲɛ.winˈdɔw.sɔˈvʲ.i
niewindowsowy	ɲɛ.win.dɔwˈsɔ.vɨ
niewindowsowych	ɲɛ.win.dɔwˈsɔ.vɨx
niewindowsowym	ɲɛ.win.dɔwˈsɔ.vɨm
niewindowsowymi	ɲɛ.win.dɔwˈsɔ.vɨˈmʲ.i
niewindsurfingowa	ɲɛ.win.tsɛr.fʲinˈɡɔ.va
niewindsurfingową	ɲɛ.win.tsɛr.fʲinˈɡɔ.vɔ̃
niewindsurfingowe	ɲɛ.win.tsɛr.fʲinˈɡɔ.vɛ
niewindsurfingowego	ɲɛ.win.tsɛr.fʲin.ɡɔˈvɛ.ɡɔ
niewindsurfingowej	ɲɛ.win.tsɛr.fʲinˈɡɔ.vɛj
niewindsurfingowemu	ɲɛ.win.tsɛr.fʲin.ɡɔˈvɛ.mu
niewindsurfingowi	ɲɛ.win.tsɛrˈfʲin.ɡɔˈvʲ.i
niewindsurfingowo	ɲɛ.win.tsɛr.fʲinˈɡɔ.vɔ
niewindsurfingowy	ɲɛ.win.tsɛr.fʲinˈɡɔ.vɨ
niewindsurfingowych	ɲɛ.win.tsɛr.fʲinˈɡɔ.vɨx
niewindsurfingowym	ɲɛ.win.tsɛr.fʲinˈɡɔ.vɨm
niewindsurfingowymi	ɲɛ.win.tsɛr.fʲinˈɡɔ.vɨˈmʲ.i
niewmarznięci	ɲɛvˈmar.zɲɛˈt͡ɕ.i
niewmarznięcia	ɲɛv.marˈzɲɛɲ.t͡ɕa
niewmarznięcie	ɲɛv.marˈzɲɛɲ.t͡ɕɛ
niewmarznięciem	ɲɛv.marˈzɲɛɲ.t͡ɕɛm
niewmarznięciu	ɲɛv.marˈzɲɛɲ.t͡ɕu
niewmarznięta	ɲɛv.marˈzɲɛn.ta
niewmarzniętą	ɲɛv.marˈzɲɛn.tɔ̃
niewmarznięte	ɲɛv.marˈzɲɛn.tɛ
niewmarzniętego	ɲɛv.mar.zɲɛnˈtɛ.ɡɔ
niewmarzniętej	ɲɛv.marˈzɲɛn.tɛj
niewmarzniętemu	ɲɛv.mar.zɲɛnˈtɛ.mu
niewmarznięty	ɲɛv.marˈzɲɛn.tɨ
niewmarzniętych	ɲɛv.marˈzɲɛn.tɨx
niewmarzniętym	ɲɛv.marˈzɲɛn.tɨm
niewmarzniętymi	ɲɛv.marˈzɲɛn.tɨˈmʲ.i
niewymarznięci	ɲɛ.vɨˈmar.zɲɛˈt͡ɕ.i
niewymarznięcia	ɲɛ.vɨ.marˈzɲɛɲ.t͡ɕa
niewymarznięcie	ɲɛ.vɨ.marˈzɲɛɲ.t͡ɕɛ
niewymarznięciem	ɲɛ.vɨ.marˈzɲɛɲ.t͡ɕɛm
niewymarznięciu	ɲɛ.vɨ.marˈzɲɛɲ.t͡ɕu
niewymarznięta	ɲɛ.vɨ.marˈzɲɛn.ta
niewymarzniętą	ɲɛ.vɨ.marˈzɲɛn.tɔ̃
niewymarznięte	ɲɛ.vɨ.marˈzɲɛn.tɛ
niewymarzniętego	ɲɛ.vɨ.mar.zɲɛnˈtɛ.ɡɔ
niewymarzniętej	ɲɛ.vɨ.marˈzɲɛn.tɛj
niewymarzniętemu	ɲɛ.vɨ.mar.zɲɛnˈtɛ.mu
niewymarznięty	ɲɛ.vɨ.marˈzɲɛn.tɨ
niewymarzniętych	ɲɛ.vɨ.marˈzɲɛn.tɨx
niewymarzniętym	ɲɛ.vɨ.marˈzɲɛn.tɨm
niewymarzniętymi	ɲɛ.vɨ.marˈzɲɛn.tɨˈmʲ.i
niezamarzająca	ɲɛ.za.mar.zaˈjɔn.t͡sa
niezamarzającą	ɲɛ.za.mar.zaˈjɔn.t͡sɔ̃
niezamarzające	ɲɛ.za.mar.zaˈjɔn.t͡sɛ
niezamarzającego	ɲɛ.za.mar.za.jɔnˈt͡sɛ.ɡɔ
niezamarzającej	ɲɛ.za.mar.zaˈjɔn.t͡sɛj
niezamarzającemu	ɲɛ.za.mar.za.jɔnˈt͡sɛ.mu
niezamarzający	ɲɛ.za.mar.zaˈjɔn.t͡sɨ
niezamarzających	ɲɛ.za.mar.zaˈjɔn.t͡sɨx
niezamarzającym	ɲɛ.za.mar.zaˈjɔn.t͡sɨm
niezamarzającymi	ɲɛ.za.mar.zaˈjɔn.t͡sɨˈmʲ.i
niezamarzana	ɲɛ.za.marˈza.na
niezamarzaną	ɲɛ.za.marˈza.nɔ̃
niezamarzane	ɲɛ.za.marˈza.nɛ
niezamarzanego	ɲɛ.za.mar.zaˈnɛ.ɡɔ
niezamarzanej	ɲɛ.za.marˈza.nɛj
niezamarzanemu	ɲɛ.za.mar.zaˈnɛ.mu
niezamarzani	ɲɛ.zaˈmar.zaˈɲ.i
niezamarzania	ɲɛ.za.marˈza.ɲa
niezamarzanie	ɲɛ.za.marˈza.ɲɛ
niezamarzaniem	ɲɛ.za.marˈza.ɲɛm
niezamarzaniu	ɲɛ.za.marˈza.ɲu
niezamarzany	ɲɛ.za.marˈza.nɨ
niezamarzanych	ɲɛ.za.marˈza.nɨx
niezamarzanym	ɲɛ.za.marˈza.nɨm
niezamarzanymi	ɲɛ.za.marˈza.nɨˈmʲ.i
niezamarznięci	ɲɛ.zaˈmar.zɲɛˈt͡ɕ.i
niezamarznięcia	ɲɛ.za.marˈzɲɛɲ.t͡ɕa
niezamarznięcie	ɲɛ.za.marˈzɲɛɲ.t͡ɕɛ
niezamarznięciem	ɲɛ.za.marˈzɲɛɲ.t͡ɕɛm
niezamarznięciu	ɲɛ.za.marˈzɲɛɲ.t͡ɕu
niezamarznięta	ɲɛ.za.marˈzɲɛn.ta
niezamarzniętą	ɲɛ.za.marˈzɲɛn.tɔ̃
niezamarznięte	ɲɛ.za.marˈzɲɛn.tɛ
niezamarzniętego	ɲɛ.za.mar.zɲɛnˈtɛ.ɡɔ
niezamarzniętej	ɲɛ.za.marˈzɲɛn.tɛj
niezamarzniętemu	ɲɛ.za.mar.zɲɛnˈtɛ.mu
niezamarznięty	ɲɛ.za.marˈzɲɛn.tɨ
niezamarzniętych	ɲɛ.za.marˈzɲɛn.tɨx
niezamarzniętym	ɲɛ.za.marˈzɲɛn.tɨm
niezamarzniętymi	ɲɛ.za.marˈzɲɛn.tɨˈmʲ.i
niezmarznięci	ɲɛzˈmar.zɲɛˈt͡ɕ.i
niezmarznięcia	ɲɛz.marˈzɲɛɲ.t͡ɕa
niezmarznięcie	ɲɛz.marˈzɲɛɲ.t͡ɕɛ
niezmarznięciem	ɲɛz.marˈzɲɛɲ.t͡ɕɛm
niezmarznięciu	ɲɛz.marˈzɲɛɲ.t͡ɕu
niezmarznięta	ɲɛz.marˈzɲɛn.ta
niezmarzniętą	ɲɛz.marˈzɲɛn.tɔ̃
niezmarznięte	ɲɛz.marˈzɲɛn.tɛ
niezmarzniętego	ɲɛz.mar.zɲɛnˈtɛ.ɡɔ
niezmarzniętej	ɲɛz.marˈzɲɛn.tɛj
niezmarzniętemu	ɲɛz.mar.zɲɛnˈtɛ.mu
niezmarznięty	ɲɛz.marˈzɲɛn.tɨ
niezmarzniętych	ɲɛz.marˈzɲɛn.tɨx
niezmarzniętym	ɲɛz.marˈzɲɛn.tɨm
niezmarzniętymi	ɲɛz.marˈzɲɛn.tɨˈmʲ.i
niezoomowana	ɲɛ.zu.mɔˈva.na
niezoomowaną	ɲɛ.zu.mɔˈva.nɔ̃
niezoomowane	ɲɛ.zu.mɔˈva.nɛ
niezoomowanego	ɲɛ.zu.mɔ.vaˈnɛ.ɡɔ
niezoomowanej	ɲɛ.zu.mɔˈva.nɛj
niezoomowanemu	ɲɛ.zu.mɔ.vaˈnɛ.mu
niezoomowani	ɲɛ.zu.mɔˈva.ɲi
niezoomowania	ɲɛ.zu.mɔˈva.ɲa
niezoomowanie	ɲɛ.zu.mɔˈva.ɲɛ
niezoomowaniem	ɲɛ.zu.mɔˈva.ɲɛm
niezoomowaniu	ɲɛ.zu.mɔˈva.ɲu
niezoomowany	ɲɛ.zu.mɔˈva.nɨ
niezoomowanych	ɲɛ.zu.mɔˈva.nɨx
niezoomowanym	ɲɛ.zu.mɔˈva.nɨm
niezoomowanymi	ɲɛ.zu.mɔ.vaˈnɨ.mʲi
niezoomująca	ɲɛ.zu.muˈjɔn.t͡sa
niezoomującą	ɲɛ.zu.muˈjɔn.t͡sɔ̃
niezoomujące	ɲɛ.zu.muˈjɔn.t͡sɛ
niezoomującego	ɲɛ.zu.mu.jɔnˈt͡sɛ.ɡɔ
niezoomującej	ɲɛ.zu.muˈjɔn.t͡sɛj
niezoomującemu	ɲɛ.zu.mu.jɔnˈt͡sɛ.mu
niezoomujący	ɲɛ.zu.muˈjɔn.t͡sɨ
niezoomujących	ɲɛ.zu.muˈjɔn.t͡sɨx
niezoomującym	ɲɛ.zu.muˈjɔn.t͡sɨm
niezoomującymi	ɲɛ.zu.mu.jɔnˈt͡sɨ.mʲi
nivea	ɲiˈvɛ.a
niveą	ɲiˈvɛ.ɔ̃
niveach	ɲiˈvɛ.ax
niveami	ɲiˈvɛ.aˈmʲ.i
nivee	ˈɲi.vɛ
niveę	ˈɲi.vɛ
niveę	ɲiˈvɛ.ɛ
nivee	ɲiˈvɛ.ʔɛ
nivei	ɲiˈvɛ.i
niveo	ɲiˈvɛ.ɔ
niveom	ɲiˈvɛ.ɔm
Noirmontier	nu.ɛr.mɔnˈti.ɛr
Nourita	nuˈrʲi.ta
Nucingen	nuˈsɔ̃.ʐɛn
Nucingen	nuˈsɔŋ.ʐɛn
Nucingena	nu.sɔŋˈʐɛ.na
Nucingena	nu.sɔ̃ˈʐɛ.na
Nucingenem	nu.sɔŋˈʐɛ.nɛm
Nucingenem	nu.sɔ̃ˈʐɛ.nɛm
Nucingenie	nu.sɔŋˈʐɛ.ɲɛ
Nucingenie	nu.sɔ̃ˈʐɛ.ɲɛ
Nueil	ˈnu.lɛj
obmarzł	ˈɔb.marzw
obmarzła	ɔbˈmar.zwa
obmarzli	ˈɔb.marsˈlʲ.i
obmarzło	ɔbˈmar.zwɔ
obmarzłszy	ɔbˈmar.zwʂɨ
obmarzły	ɔbˈmar.zwɨ
obmarzną	ɔbˈmar.znɔ̃
obmarznąć	ɔbˈmar.znɔɲt͡ɕ
obmarznę	ɔbˈmar.znɛ
obmarznie	ɔbˈmar.zɲɛ
obmarznięci	ɔbˈmar.zɲɛˈt͡ɕ.i
obmarznięcia	ɔb.marˈzɲɛɲ.t͡ɕa
obmarzniecie	ɔb.marˈzɲɛ.t͡ɕɛ
obmarznięcie	ɔb.marˈzɲɛɲ.t͡ɕɛ
obmarznięciem	ɔb.marˈzɲɛɲ.t͡ɕɛm
obmarznięciu	ɔb.marˈzɲɛɲ.t͡ɕu
obmarzniemy	ɔb.marˈzɲɛ.mɨ
obmarzniesz	ɔbˈmar.zɲɛʂ
obmarznięta	ɔb.marˈzɲɛn.ta
obmarzniętą	ɔb.marˈzɲɛn.tɔ̃
obmarznięte	ɔb.marˈzɲɛn.tɛ
obmarzniętego	ɔb.mar.zɲɛnˈtɛ.ɡɔ
obmarzniętej	ɔb.marˈzɲɛn.tɛj
obmarzniętemu	ɔb.mar.zɲɛnˈtɛ.mu
obmarznięto	ɔb.marˈzɲɛn.tɔ
obmarznięty	ɔb.marˈzɲɛn.tɨ
obmarzniętych	ɔb.marˈzɲɛn.tɨx
obmarzniętym	ɔb.marˈzɲɛn.tɨm
obmarzniętymi	ɔb.marˈzɲɛn.tɨˈmʲ.i
obmarznij	ɔbˈmar.zɲij
obmarznijcie	ɔb.marˈzɲij.t͡ɕɛ
obmarznijmy	ɔb.marˈzɲij.mɨ
O'Brien	ɔˈbra.jan
O'Brien	ɔˈbra.jɛn
O'Briena	ɔ.braˈja.na
O'Briena	ɔ.braˈjɛ.na
octavia	ɔkˈta.vʲa
octavią	ɔkˈta.vʲɔ̃
octaviach	ɔkˈta.vʲax
octaviami	ɔkˈta.vʲaˈmʲ.i
octavie	ɔkˈta.vʲɛ
octavię	ɔkˈta.vʲɛ
octavii	ˈɔk.taˈvʲ.i
octavio	ɔkˈta.vʲɔ
octaviom	ɔkˈta.vʲɔm
odmarzł	ˈɔd.marzw
odmarzła	ɔdˈmar.zwa
odmarzli	ˈɔd.marsˈlʲ.i
odmarzło	ɔdˈmar.zwɔ
odmarzłszy	ɔdˈmar.zwʂɨ
odmarzły	ɔdˈmar.zwɨ
odmarzną	ɔdˈmar.znɔ̃
odmarznąć	ɔdˈmar.znɔɲt͡ɕ
odmarznę	ɔdˈmar.znɛ
odmarznie	ɔdˈmar.zɲɛ
odmarznięci	ɔdˈmar.zɲɛˈt͡ɕ.i
odmarznięcia	ɔd.marˈzɲɛɲ.t͡ɕa
odmarzniecie	ɔd.marˈzɲɛ.t͡ɕɛ
odmarznięcie	ɔd.marˈzɲɛɲ.t͡ɕɛ
odmarznięciem	ɔd.marˈzɲɛɲ.t͡ɕɛm
odmarznięciu	ɔd.marˈzɲɛɲ.t͡ɕu
odmarzniemy	ɔd.marˈzɲɛ.mɨ
odmarzniesz	ɔdˈmar.zɲɛʂ
odmarznięta	ɔd.marˈzɲɛn.ta
odmarzniętą	ɔd.marˈzɲɛn.tɔ̃
odmarznięte	ɔd.marˈzɲɛn.tɛ
odmarzniętego	ɔd.mar.zɲɛnˈtɛ.ɡɔ
odmarzniętej	ɔd.marˈzɲɛn.tɛj
odmarzniętemu	ɔd.mar.zɲɛnˈtɛ.mu
odmarznięto	ɔd.marˈzɲɛn.tɔ
odmarznięty	ɔd.marˈzɲɛn.tɨ
odmarzniętych	ɔd.marˈzɲɛn.tɨx
odmarzniętym	ɔd.marˈzɲɛn.tɨm
odmarzniętymi	ɔd.marˈzɲɛn.tɨˈmʲ.i
odmarznij	ɔdˈmar.zɲij
odmarznijcie	ɔd.marˈzɲij.t͡ɕɛ
odmarznijmy	ɔd.marˈzɲij.mɨ
offsecie	ɔfˈsɛ.t͡ɕɛ
offset	ˈɔf.sɛt
offsetach	ɔfˈsɛ.tax
offsetami	ɔfˈsɛ.taˈmʲ.i
offsetem	ɔfˈsɛ.tɛm
offsetobiorca	ɔf.sɛ.tɔˈbʲɔr.t͡sa
offsetobiorcą	ɔf.sɛ.tɔˈbʲɔr.t͡sɔ̃
offsetobiorcach	ɔf.sɛ.tɔˈbʲɔr.t͡sax
offsetobiorcami	ɔf.sɛ.tɔˈbʲɔr.t͡saˈmʲ.i
offsetobiorce	ɔf.sɛ.tɔˈbʲɔr.t͡sɛ
offsetobiorcę	ɔf.sɛ.tɔˈbʲɔr.t͡sɛ
offsetobiorco	ɔf.sɛ.tɔˈbʲɔr.t͡sɔ
offsetobiorcom	ɔf.sɛ.tɔˈbʲɔr.t͡sɔm
offsetobiorców	ɔf.sɛ.tɔˈbʲɔr.t͡suf
offsetobiorcy	ɔf.sɛ.tɔˈbʲɔr.t͡sɨ
offsetodawca	ɔf.sɛ.tɔˈdaf.t͡sa
offsetodawcą	ɔf.sɛ.tɔˈdaf.t͡sɔ̃
offsetodawcach	ɔf.sɛ.tɔˈdaf.t͡sax
offsetodawcami	ɔf.sɛ.tɔˈdaf.t͡saˈmʲ.i
offsetodawce	ɔf.sɛ.tɔˈdaf.t͡sɛ
offsetodawcę	ɔf.sɛ.tɔˈdaf.t͡sɛ
offsetodawco	ɔf.sɛ.tɔˈdaf.t͡sɔ
offsetodawcom	ɔf.sɛ.tɔˈdaf.t͡sɔm
offsetodawców	ɔf.sɛ.tɔˈdaf.t͡suf
offsetodawcy	ɔf.sɛ.tɔˈdaf.t͡sɨ
offsetom	ɔfˈsɛ.tɔm
offsetów	ɔfˈsɛ.tuf
offsetowa	ɔf.sɛˈtɔ.va
offsetową	ɔf.sɛˈtɔ.vɔ̃
offsetowe	ɔf.sɛˈtɔ.vɛ
offsetowego	ɔf.sɛ.tɔˈvɛ.ɡɔ
offsetowej	ɔf.sɛˈtɔ.vɛj
offsetowemu	ɔf.sɛ.tɔˈvɛ.mu
offsetowi	ɔfˈsɛ.tɔˈvʲ.i
offsetowy	ɔf.sɛˈtɔ.vɨ
offsetowych	ɔf.sɛˈtɔ.vɨx
offsetowym	ɔf.sɛˈtɔ.vɨm
offsetowymi	ɔf.sɛˈtɔ.vɨˈmʲ.i
offsetu	ɔfˈsɛ.tu
offsety	ɔfˈsɛ.tɨ
Oh	ɔ
omarzł	ˈɔ.marzw
omarzła	ɔˈmar.zwa
omarzli	ˈɔ.marsˈlʲ.i
omarzło	ɔˈmar.zwɔ
omarzłszy	ɔˈmar.zwʂɨ
omarzły	ɔˈmar.zwɨ
omarzną	ɔˈmar.znɔ̃
omarznąć	ɔˈmar.znɔɲt͡ɕ
omarznę	ɔˈmar.znɛ
omarznie	ɔˈmar.zɲɛ
omarznięci	ɔˈmar.zɲɛˈt͡ɕ.i
omarznięcia	ɔ.marˈzɲɛɲ.t͡ɕa
omarzniecie	ɔ.marˈzɲɛ.t͡ɕɛ
omarznięcie	ɔ.marˈzɲɛɲ.t͡ɕɛ
omarznięciem	ɔ.marˈzɲɛɲ.t͡ɕɛm
omarznięciu	ɔ.marˈzɲɛɲ.t͡ɕu
omarzniemy	ɔ.marˈzɲɛ.mɨ
omarzniesz	ɔˈmar.zɲɛʂ
omarznięta	ɔ.marˈzɲɛn.ta
omarzniętą	ɔ.marˈzɲɛn.tɔ̃
omarznięte	ɔ.marˈzɲɛn.tɛ
omarzniętego	ɔ.mar.zɲɛnˈtɛ.ɡɔ
omarzniętej	ɔ.marˈzɲɛn.tɛj
omarzniętemu	ɔ.mar.zɲɛnˈtɛ.mu
omarznięto	ɔ.marˈzɲɛn.tɔ
omarznięty	ɔ.marˈzɲɛn.tɨ
omarzniętych	ɔ.marˈzɲɛn.tɨx
omarzniętym	ɔ.marˈzɲɛn.tɨm
omarzniętymi	ɔ.marˈzɲɛn.tɨˈmʲ.i
omarznij	ɔˈmar.zɲij
omarznijcie	ɔ.marˈzɲij.t͡ɕɛ
omarznijmy	ɔ.marˈzɲij.mɨ
O'Neal	ˈɔ.ɲil
O'Neala	ɔˈɲi.la
O'Nealach	ɔˈɲi.lax
O'Nealami	ɔ.ɲiˈla.mʲi
O'Nealami	ɔˈɲi.laˈmʲ.i
O'Neale	ɔˈɲi.lɛ
O'Nealem	ɔˈɲi.lɛm
O'Nealom	ɔˈɲi.lɔm
O'Nealów	ɔˈɲi.luf
O'Nealowi	ɔ.ɲiˈlɔ.vʲi
O'Nealowi	ɔˈɲi.lɔˈvʲ.i
O'Nealowie	ɔ.ɲiˈlɔ.vʲɛ
O'Nealu	ɔˈɲi.lu
O'Reilly	ˈɔ.rajˈlʲ.i
O'Reilly	ɔˈraj.lʲi
O'Reillych	ɔˈraj.lʲix
O'Reilly'ego	ɔ.rajˈlʲɛ.ɡɔ
O'Reilly'emu	ɔ.rajˈlʲɛ.mu
O'Reillym	ɔˈraj.lʲim
O'Reillymi	ɔ.rajˈlʲi.mʲi
O'Reillymi	ɔˈraj.lʲiˈmʲ.i
O'Reilly'owie	ɔ.rajˈlʲɔ.vʲɛ
O'Shea	ˈɔ.ʂɛ
O'Shea	ˈɔ.ʂɛj
outsider	awˈtsaj.dɛr
outsidera	aw.tsajˈdɛ.ra
outsiderach	aw.tsajˈdɛ.rax
outsiderami	aw.tsajˈdɛ.raˈmʲ.i
outsiderem	aw.tsajˈdɛ.rɛm
outsiderom	aw.tsajˈdɛ.rɔm
outsiderów	aw.tsajˈdɛ.ruf
outsiderowi	aw.tsajˈdɛ.rɔˈvʲ.i
outsidery	aw.tsajˈdɛ.rɨ
outsiderze	aw.tsajˈdɛ.ʐɛ
outsiderzy	aw.tsajˈdɛ.ʐɨ
Ouvrard	ˈɔ.vrar
Oxford	ˈɔk.sfɔrt
oxfordach	ɔkˈsfɔr.dax
oxfordami	ɔkˈsfɔr.daˈmʲ.i
Oxfordem	ɔkˈsfɔr.dɛm
oxfordom	ɔkˈsfɔr.dɔm
oxfordów	ɔkˈsfɔr.duf
Oxfordowi	ɔk.sfɔrˈdɔ.vʲi
Oxfordowi	ɔkˈsfɔr.dɔˈvʲ.i
Oxfordu	ɔkˈsfɔr.du
oxfordy	ɔkˈsfɔr.dɨ
Oxfordzie	ɔkˈsfɔr.d͡ʑɛ
Paddy	ˈpa.di
Paddy'ego	pa.diˈɛ.ɡɔ
Palais-Royal	pa.laˈrɔ.jal
parfois	ˈpa.rfwa
Pâris	ˈpa.rʲi
Pâris	paˈrʲ.i
pas	pa
Pascal	ˈpa.skal
Pascala	paˈska.la
Pascalem	paˈska.lɛm
Pathé	ˈpa.fɛ
Pearls	pɛrls
peerelowscy	pɛ.ɛ.rɛˈlɔf.st͡sɨ
peerelowska	pɛ.ɛ.rɛˈlɔf.ska
peerelowską	pɛ.ɛ.rɛˈlɔf.skɔ̃
peerelowski	pɛ.ɛˈrɛ.lɔfsˈkʲ.i
peerelowskich	pɛ.ɛ.rɛˈlɔf.skʲix
peerelowskie	pɛ.ɛ.rɛˈlɔf.skʲɛ
peerelowskiego	pɛ.ɛ.rɛ.lɔfˈskʲɛ.ɡɔ
peerelowskiej	pɛ.ɛ.rɛˈlɔf.skʲɛj
peerelowskiemu	pɛ.ɛ.rɛ.lɔfˈskʲɛ.mu
peerelowskim	pɛ.ɛ.rɛˈlɔf.skʲim
peerelowskimi	pɛ.ɛ.rɛˈlɔf.skʲiˈmʲ.i
peerelowsko	pɛ.ɛ.rɛˈlɔf.skɔ
peerelowsku	pɛ.ɛ.rɛˈlɔf.sku
peeselowscy	pɛ.ɛ.sɛˈlɔf.st͡sɨ
peeselowska	pɛ.ɛ.sɛˈlɔf.ska
peeselowską	pɛ.ɛ.sɛˈlɔf.skɔ̃
peeselowski	pɛ.ɛˈsɛ.lɔfsˈkʲ.i
peeselowskich	pɛ.ɛ.sɛˈlɔf.skʲix
peeselowskie	pɛ.ɛ.sɛˈlɔf.skʲɛ
peeselowskiego	pɛ.ɛ.sɛ.lɔfˈskʲɛ.ɡɔ
peeselowskiej	pɛ.ɛ.sɛˈlɔf.skʲɛj
peeselowskiemu	pɛ.ɛ.sɛ.lɔfˈskʲɛ.mu
peeselowskim	pɛ.ɛ.sɛˈlɔf.skʲim
peeselowskimi	pɛ.ɛ.sɛˈlɔf.skʲiˈmʲ.i
peeselowsko	pɛ.ɛ.sɛˈlɔf.skɔ
peeselowsku	pɛ.ɛ.sɛˈlɔf.sku
Perefix	pɛˈrɛ.fʲiks
Perrult	ˈpɛ.rult
Pew	pʲu
Pierrot	ˈpʲɛ.rɔ
pince-nez	ˈpʲin.snɛ
pluits	pwi
podmarzł	ˈpɔd.marzw
podmarzła	pɔdˈmar.zwa
podmarzli	ˈpɔd.marsˈlʲ.i
podmarzło	pɔdˈmar.zwɔ
podmarzłszy	pɔdˈmar.zwʂɨ
podmarzły	pɔdˈmar.zwɨ
podmarzną	pɔdˈmar.znɔ̃
podmarznąć	pɔdˈmar.znɔɲt͡ɕ
podmarznę	pɔdˈmar.znɛ
podmarznie	pɔdˈmar.zɲɛ
podmarznięci	pɔdˈmar.zɲɛˈt͡ɕ.i
podmarznięcia	pɔd.marˈzɲɛɲ.t͡ɕa
podmarzniecie	pɔd.marˈzɲɛ.t͡ɕɛ
podmarznięcie	pɔd.marˈzɲɛɲ.t͡ɕɛ
podmarznięciem	pɔd.marˈzɲɛɲ.t͡ɕɛm
podmarznięciu	pɔd.marˈzɲɛɲ.t͡ɕu
podmarzniemy	pɔd.marˈzɲɛ.mɨ
podmarzniesz	pɔdˈmar.zɲɛʂ
podmarznięta	pɔd.marˈzɲɛn.ta
podmarzniętą	pɔd.marˈzɲɛn.tɔ̃
podmarznięte	pɔd.marˈzɲɛn.tɛ
podmarzniętego	pɔd.mar.zɲɛnˈtɛ.ɡɔ
podmarzniętej	pɔd.marˈzɲɛn.tɛj
podmarzniętemu	pɔd.mar.zɲɛnˈtɛ.mu
podmarznięto	pɔd.marˈzɲɛn.tɔ
podmarznięty	pɔd.marˈzɲɛn.tɨ
podmarzniętych	pɔd.marˈzɲɛn.tɨx
podmarzniętym	pɔd.marˈzɲɛn.tɨm
podmarzniętymi	pɔd.marˈzɲɛn.tɨˈmʲ.i
podmarznij	pɔdˈmar.zɲij
podmarznijcie	pɔd.marˈzɲij.t͡ɕɛ
podmarznijmy	pɔd.marˈzɲij.mɨ
Poissonière	pɔˈsɔ.ɲɛr
Polly	ˈpɔ.lʲi
Polly	pɔˈlʲ.i
pomarzł	ˈpɔ.marzw
pomarzła	pɔˈmar.zwa
pomarzli	ˈpɔ.marsˈlʲ.i
pomarzło	pɔˈmar.zwɔ
pomarzłszy	pɔˈmar.zwʂɨ
pomarzły	pɔˈmar.zwɨ
pomarzną	pɔˈmar.znɔ̃
pomarznąć	pɔˈmar.znɔɲt͡ɕ
pomarznę	pɔˈmar.znɛ
pomarznie	pɔˈmar.zɲɛ
pomarznięci	pɔˈmar.zɲɛˈt͡ɕ.i
pomarznięcia	pɔ.marˈzɲɛɲ.t͡ɕa
pomarzniecie	pɔ.marˈzɲɛ.t͡ɕɛ
pomarznięcie	pɔ.marˈzɲɛɲ.t͡ɕɛ
pomarznięciem	pɔ.marˈzɲɛɲ.t͡ɕɛm
pomarznięciu	pɔ.marˈzɲɛɲ.t͡ɕu
pomarzniemy	pɔ.marˈzɲɛ.mɨ
pomarzniesz	pɔˈmar.zɲɛʂ
pomarznięta	pɔ.marˈzɲɛn.ta
pomarzniętą	pɔ.marˈzɲɛn.tɔ̃
pomarznięte	pɔ.marˈzɲɛn.tɛ
pomarzniętego	pɔ.mar.zɲɛnˈtɛ.ɡɔ
pomarzniętej	pɔ.marˈzɲɛn.tɛj
pomarzniętemu	pɔ.mar.zɲɛnˈtɛ.mu
pomarznięto	pɔ.marˈzɲɛn.tɔ
pomarznięty	pɔ.marˈzɲɛn.tɨ
pomarzniętych	pɔ.marˈzɲɛn.tɨx
pomarzniętym	pɔ.marˈzɲɛn.tɨm
pomarzniętymi	pɔ.marˈzɲɛn.tɨˈmʲ.i
pomarznij	pɔˈmar.zɲij
pomarznijcie	pɔ.marˈzɲij.t͡ɕɛ
pomarznijmy	pɔ.marˈzɲij.mɨ
Pompadour	pɔmˈpa.dur
pool	pul
poola	ˈpu.la
poolach	ˈpu.lax
poolami	ˈpu.laˈmʲ.i
poole	ˈpu.lɛ
poolem	ˈpu.lɛm
pooli	puˈlʲ.i
poolom	ˈpu.lɔm
poolowi	ˈpu.lɔˈvʲ.i
poolu	ˈpu.lu
Popelinière	pɔ.pɛˈlʲi.ɲɛr
Postscriptum	pɔˈstskrʲip.tum
potpourri	ˈpɔt.puˈrʲ.i
pour	pɛr
pozamarza	pɔ.zaˈmar.za
pozamarzać	pɔ.zaˈmar.zat͡ɕ
pozamarzacie	pɔ.za.marˈza.t͡ɕɛ
pozamarzaj	pɔ.zaˈmar.zaj
pozamarzają	pɔ.za.marˈza.jɔ̃
pozamarzajcie	pɔ.za.marˈzaj.t͡ɕɛ
pozamarzajmy	pɔ.za.marˈzaj.mɨ
pozamarzał	pɔ.zaˈmar.zaw
pozamarzała	pɔ.za.marˈza.wa
pozamarzali	pɔ.zaˈmar.zaˈlʲ.i
pozamarzało	pɔ.za.marˈza.wɔ
pozamarzały	pɔ.za.marˈza.wɨ
pozamarzam	pɔ.zaˈmar.zam
pozamarzamy	pɔ.za.marˈza.mɨ
pozamarzana	pɔ.za.marˈza.na
pozamarzaną	pɔ.za.marˈza.nɔ̃
pozamarzane	pɔ.za.marˈza.nɛ
pozamarzanego	pɔ.za.mar.zaˈnɛ.ɡɔ
pozamarzanej	pɔ.za.marˈza.nɛj
pozamarzanemu	pɔ.za.mar.zaˈnɛ.mu
pozamarzani	pɔ.zaˈmar.zaˈɲ.i
pozamarzania	pɔ.za.marˈza.ɲa
pozamarzanie	pɔ.za.marˈza.ɲɛ
pozamarzaniem	pɔ.za.marˈza.ɲɛm
pozamarzaniu	pɔ.za.marˈza.ɲu
pozamarzano	pɔ.za.marˈza.nɔ
pozamarzany	pɔ.za.marˈza.nɨ
pozamarzanych	pɔ.za.marˈza.nɨx
pozamarzanym	pɔ.za.marˈza.nɨm
pozamarzanymi	pɔ.za.marˈza.nɨˈmʲ.i
pozamarzasz	pɔ.zaˈmar.zaʂ
pozamarzawszy	pɔ.za.marˈzaf.ʂɨ
Providence	prɔˈvʲi.dɛns
provider	prɔˈvaj.dɛr
providera	prɔ.vajˈdɛ.ra
providerach	prɔ.vajˈdɛ.rax
providerami	prɔ.vajˈdɛ.raˈmʲ.i
providerem	prɔ.vajˈdɛ.rɛm
providerom	prɔ.vajˈdɛ.rɔm
providerów	prɔ.vajˈdɛ.ruf
providerowi	prɔ.vajˈdɛ.rɔˈvʲ.i
providery	prɔ.vajˈdɛ.rɨ
providerze	prɔ.vajˈdɛ.ʐɛ
providerzy	prɔ.vajˈdɛ.ʐɨ
Prud'homme	ˈpru.dɔm
przemarzł	ˈpʂɛ.marzw
przemarzła	pʂɛˈmar.zwa
przemarzli	ˈpʂɛ.marsˈlʲ.i
przemarzło	pʂɛˈmar.zwɔ
przemarzłszy	pʂɛˈmar.zwʂɨ
przemarzły	pʂɛˈmar.zwɨ
przemarzną	pʂɛˈmar.znɔ̃
przemarznąć	pʂɛˈmar.znɔɲt͡ɕ
przemarznę	pʂɛˈmar.znɛ
przemarznie	pʂɛˈmar.zɲɛ
przemarznięci	pʂɛˈmar.zɲɛˈt͡ɕ.i
przemarznięcia	pʂɛ.marˈzɲɛɲ.t͡ɕa
przemarzniecie	pʂɛ.marˈzɲɛ.t͡ɕɛ
przemarznięcie	pʂɛ.marˈzɲɛɲ.t͡ɕɛ
przemarznięciem	pʂɛ.marˈzɲɛɲ.t͡ɕɛm
przemarznięciu	pʂɛ.marˈzɲɛɲ.t͡ɕu
przemarzniemy	pʂɛ.marˈzɲɛ.mɨ
przemarzniesz	pʂɛˈmar.zɲɛʂ
przemarznięta	pʂɛ.marˈzɲɛn.ta
przemarzniętą	pʂɛ.marˈzɲɛn.tɔ̃
przemarznięte	pʂɛ.marˈzɲɛn.tɛ
przemarzniętego	pʂɛ.mar.zɲɛnˈtɛ.ɡɔ
przemarzniętej	pʂɛ.marˈzɲɛn.tɛj
przemarzniętemu	pʂɛ.mar.zɲɛnˈtɛ.mu
przemarznięto	pʂɛ.marˈzɲɛn.tɔ
przemarznięty	pʂɛ.marˈzɲɛn.tɨ
przemarzniętych	pʂɛ.marˈzɲɛn.tɨx
przemarzniętym	pʂɛ.marˈzɲɛn.tɨm
przemarzniętymi	pʂɛ.marˈzɲɛn.tɨˈmʲ.i
przemarznij	pʂɛˈmar.zɲij
przemarznijcie	pʂɛ.marˈzɲij.t͡ɕɛ
przemarznijmy	pʂɛ.marˈzɲij.mɨ
przymarzł	ˈpʂɨ.marzw
przymarzła	pʂɨˈmar.zwa
przymarzli	ˈpʂɨ.marsˈlʲ.i
przymarzło	pʂɨˈmar.zwɔ
przymarzłszy	pʂɨˈmar.zwʂɨ
przymarzły	pʂɨˈmar.zwɨ
przymarzną	pʂɨˈmar.znɔ̃
przymarznąć	pʂɨˈmar.znɔɲt͡ɕ
przymarznę	pʂɨˈmar.znɛ
przymarznie	pʂɨˈmar.zɲɛ
przymarznięci	pʂɨˈmar.zɲɛˈt͡ɕ.i
przymarznięcia	pʂɨ.marˈzɲɛɲ.t͡ɕa
przymarzniecie	pʂɨ.marˈzɲɛ.t͡ɕɛ
przymarznięcie	pʂɨ.marˈzɲɛɲ.t͡ɕɛ
przymarznięciem	pʂɨ.marˈzɲɛɲ.t͡ɕɛm
przymarznięciu	pʂɨ.marˈzɲɛɲ.t͡ɕu
przymarzniemy	pʂɨ.marˈzɲɛ.mɨ
przymarzniesz	pʂɨˈmar.zɲɛʂ
przymarznięta	pʂɨ.marˈzɲɛn.ta
przymarzniętą	pʂɨ.marˈzɲɛn.tɔ̃
przymarznięte	pʂɨ.marˈzɲɛn.tɛ
przymarzniętego	pʂɨ.mar.zɲɛnˈtɛ.ɡɔ
przymarzniętej	pʂɨ.marˈzɲɛn.tɛj
przymarzniętemu	pʂɨ.mar.zɲɛnˈtɛ.mu
przymarznięto	pʂɨ.marˈzɲɛn.tɔ
przymarznięty	pʂɨ.marˈzɲɛn.tɨ
przymarzniętych	pʂɨ.marˈzɲɛn.tɨx
przymarzniętym	pʂɨ.marˈzɲɛn.tɨm
przymarzniętymi	pʂɨ.marˈzɲɛn.tɨˈmʲ.i
przymarznij	pʂɨˈmar.zɲij
przymarznijcie	pʂɨ.marˈzɲij.t͡ɕɛ
przymarznijmy	pʂɨ.marˈzɲij.mɨ
quad	kwat
quad	kwɔt
quada	ˈkwa.da
quada	ˈkwɔ.da
quadach	ˈkwa.dax
quadach	ˈkwɔ.dax
quadami	ˈkwa.daˈmʲ.i
quadami	ˈkwɔ.daˈmʲ.i
quadem	ˈkwa.dɛm
quadem	ˈkwɔ.dɛm
quadom	ˈkwa.dɔm
quadom	ˈkwɔ.dɔm
quadów	ˈkwa.duf
quadów	ˈkwɔ.duf
quadowi	ˈkwa.dɔˈvʲ.i
quadowi	ˈkwɔ.dɔˈvʲ.i
quady	ˈkwa.dɨ
quady	ˈkwɔ.dɨ
quadzie	ˈkwa.d͡ʑɛ
quadzie	ˈkwɔ.d͡ʑɛ
Quai	kɛ
quantum	ˈkfan.tum
qui	kˈvʲ.i
Quixada	kʲikˈsa.da
quo	kfɔ
Quotidienne	kwa.tiˈdi.ɔ̃
Racine	ˈra.sin
Racine'a	raˈsi.na
Racine'owi	ra.siˈnɔ.vʲi
Rameau	ˈra.mɔ
Rastignac	raˈsti.ɲak
Rastignaca	ra.stiˈɲa.ka
Rastignacowi	ra.sti.ɲaˈkɔ.vʲi
Rastignacowi	ra.stiˈɲa.kɔˈvʲ.i
Reagan	ˈrɛ.ɡan
Reagana	rɛˈɡa.na
Reaganach	rɛˈɡa.nax
Reaganami	rɛ.ɡaˈna.mʲi
Reaganami	rɛˈɡa.naˈmʲ.i
Reaganem	rɛˈɡa.nɛm
Reaganie	rɛˈɡa.ɲɛ
Reaganom	rɛˈɡa.nɔm
Reaganów	rɛˈɡa.nuf
Reaganowi	rɛ.ɡaˈnɔ.vʲi
Reaganowi	rɛˈɡa.nɔˈvʲ.i
Reaganowie	rɛ.ɡaˈnɔ.vʲɛ
Reagany	rɛˈɡa.nɨ
Redruth	ˈrɛ.drut
Redrutha	rɛˈdru.ta
Redruthem	rɛˈdru.tɛm
Reilly	ˈraj.lʲi
Reilly	rajˈlʲ.i
Reillych	ˈraj.lʲix
Reilly'ego	rajˈlʲɛ.ɡɔ
Reilly'emu	rajˈlʲɛ.mu
Reillym	ˈraj.lʲim
Reillymi	ˈraj.lʲiˈmʲ.i
Reillymi	rajˈlʲi.mʲi
Reilly'owie	rajˈlʲɔ.vʲɛ
Restaud	ˈrɛ.stu
Reymont	ˈrɛj.mɔnt
Rice	rajs
Rice'a	ˈraj.sa
Rice'ach	ˈraj.sax
Rice'ami	ˈraj.saˈmʲ.i
Rice'ami	rajˈsa.mʲi
Rice'em	ˈraj.sɛm
Rice'om	ˈraj.sɔm
Rice'ów	ˈraj.suf
Rice'owi	ˈraj.sɔˈvʲ.i
Rice'owi	rajˈsɔ.vʲi
Rice'owie	rajˈsɔ.vʲɛ
Richelieu	rʲiˈʂɛl.jɛ
rides	rʲit
Riki-Tiki-Tavi	rʲi.kʲi.ti.kʲiˈta.vʲi
Risie	ˈraj.ɕɛ
Riverson	rʲiˈvɛr.sɔn
roadster	ˈrɔw.tstɛr
roadstera	rɔwˈtstɛ.ra
roadsterach	rɔwˈtstɛ.rax
roadsterami	rɔwˈtstɛ.raˈmʲ.i
roadsterem	rɔwˈtstɛ.rɛm
roadsterom	rɔwˈtstɛ.rɔm
roadsterów	rɔwˈtstɛ.ruf
roadsterowi	rɔwˈtstɛ.rɔˈvʲ.i
roadsteru	rɔwˈtstɛ.ru
roadstery	rɔwˈtstɛ.rɨ
roadsterze	rɔwˈtstɛ.ʐɛ
Roger	ˈrɔ.d͡ʐɛr
Rogers	ˈrɔ.d͡ʐɛrs
Rogersa	rɔˈd͡ʐɛr.sa
Rogersowi	rɔ.d͡ʐɛrˈsɔ.vʲi
Rogersowi	rɔˈd͡ʐɛr.sɔˈvʲ.i
Roguin	ˈrɔ.ʐɔ̃
Rossiniego	rɔ.siˈɲɛ.ɡɔ
Rousseau	ˈrus.sɔ
Royal	ˈrɔ.jal
Royalu	rɔˈja.lu
Royer-Collard	rɔ.jɛˈkɔ.lart
Royer-Collarda	rɔ.jɛ.kɔˈlar.da
rozmarzł	ˈrɔz.marzw
rozmarzła	rɔzˈmar.zwa
rozmarzli	ˈrɔz.marsˈlʲ.i
rozmarzło	rɔzˈmar.zwɔ
rozmarzłszy	rɔzˈmar.zwʂɨ
rozmarzły	rɔzˈmar.zwɨ
rozmarzną	rɔzˈmar.znɔ̃
rozmarznąć	rɔzˈmar.znɔɲt͡ɕ
rozmarznę	rɔzˈmar.znɛ
rozmarznie	rɔzˈmar.zɲɛ
rozmarznięci	rɔzˈmar.zɲɛˈt͡ɕ.i
rozmarznięcia	rɔz.marˈzɲɛɲ.t͡ɕa
rozmarzniecie	rɔz.marˈzɲɛ.t͡ɕɛ
rozmarznięcie	rɔz.marˈzɲɛɲ.t͡ɕɛ
rozmarznięciem	rɔz.marˈzɲɛɲ.t͡ɕɛm
rozmarznięciu	rɔz.marˈzɲɛɲ.t͡ɕu
rozmarzniemy	rɔz.marˈzɲɛ.mɨ
rozmarzniesz	rɔzˈmar.zɲɛʂ
rozmarznięta	rɔz.marˈzɲɛn.ta
rozmarzniętą	rɔz.marˈzɲɛn.tɔ̃
rozmarznięte	rɔz.marˈzɲɛn.tɛ
rozmarzniętego	rɔz.mar.zɲɛnˈtɛ.ɡɔ
rozmarzniętej	rɔz.marˈzɲɛn.tɛj
rozmarzniętemu	rɔz.mar.zɲɛnˈtɛ.mu
rozmarznięto	rɔz.marˈzɲɛn.tɔ
rozmarznięty	rɔz.marˈzɲɛn.tɨ
rozmarzniętych	rɔz.marˈzɲɛn.tɨx
rozmarzniętym	rɔz.marˈzɲɛn.tɨm
rozmarzniętymi	rɔz.marˈzɲɛn.tɨˈmʲ.i
rozmarznij	rɔzˈmar.zɲij
rozmarznijcie	rɔz.marˈzɲij.t͡ɕɛ
rozmarznijmy	rɔz.marˈzɲij.mɨ
Rudyard	ˈrud.jart
Saavedra	saˈvɛ.dra
Sainte-Sevère	sanˈsɛ.vɛr
Saint-Germain	sanˈʐɛr.mɛ
Saint-Germain	sɛŋˈʐɛr.man
Saint-Honoré	sɛ̃.ɔˈnɔ.rɛ
Saint-Lazare	sɛˈla.zar
Saint-Lazare	sɛ̃ˈla.zar
Sancerre	ˈsan.kɛr
Sancho	ˈsan.t͡ʂɔ
Savannah	saˈva.na
Savary	ˈsa.vrɨ
Sawyer	ˈsɔ.jɛr
Sawyera	sɔˈjɛ.ra
schon	ʂɔn
Schontz	ʂɔnt͡s
Scott	skɔt
Scribe'a	ˈskraj.ba
sechse	ˈzɛx.sɛ
Segowli	sɛˈɡɔw.lʲi
sestiere	sɛˈsti.rɛ
Shamlegh	ˈsxam.lɛk
Shandy	ˈʂan.dɨ
sharp	ʂarp
sharpa	ˈʂar.pa
sharpach	ˈʂar.pax
sharpami	ˈʂar.paˈmʲ.i
sharpem	ˈʂar.pɛm
sharpie	ˈʂar.pʲɛ
sharpom	ˈʂar.pɔm
sharpów	ˈʂar.puf
sharpowi	ˈʂar.pɔˈvʲ.i
sharpy	ˈʂar.pɨ
shell	ʂɛl
shella	ˈʂɛ.la
shellach	ˈʂɛ.lax
shellami	ˈʂɛ.laˈmʲ.i
shelle	ˈʂɛ.lɛ
shellem	ˈʂɛ.lɛm
shellom	ˈʂɛ.lɔm
shellów	ˈʂɛ.luf
shellowi	ˈʂɛ.lɔˈvʲ.i
shellu	ˈʂɛ.lu
sic	sik
Sid	sit
Sida	ˈsi.da
silikon	siˈlʲi.kɔn
silikonach	si.lʲiˈkɔ.nax
silikonami	si.lʲiˈkɔ.naˈmʲ.i
silikonem	si.lʲiˈkɔ.nɛm
silikonie	si.lʲiˈkɔ.ɲɛ
silikonom	si.lʲiˈkɔ.nɔm
silikonów	si.lʲiˈkɔ.nuf
silikonowi	si.lʲiˈkɔ.nɔˈvʲ.i
silikonu	si.lʲiˈkɔ.nu
silikony	si.lʲiˈkɔ.nɨ
Silver	ˈsil.vɛr
Silvera	silˈvɛ.ra
Silverem	silˈvɛ.rɛm
Silverowi	sil.vɛˈrɔ.vʲi
Silverowi	silˈvɛ.rɔˈvʲ.i
Silverze	silˈvɛ.ʐɛ
Sind	sint
singel	ˈsin.ɡɛl
singelce	sinˈɡɛl.t͡sɛ
singelek	sinˈɡɛ.lɛk
singelka	sinˈɡɛl.ka
singelką	sinˈɡɛl.kɔ̃
singelkach	sinˈɡɛl.kax
singelkami	sinˈɡɛl.kaˈmʲ.i
singelkę	sinˈɡɛl.kɛ
singelki	ˈsin.ɡɛlˈkʲ.i
singelko	sinˈɡɛl.kɔ
singelkom	sinˈɡɛl.kɔm
singiel	ˈsin.ɡʲɛl
singielce	sinˈɡʲɛl.t͡sɛ
singielek	sinˈɡʲɛ.lɛk
singielka	sinˈɡʲɛl.ka
singielką	sinˈɡʲɛl.kɔ̃
singielkach	sinˈɡʲɛl.kax
singielkami	sinˈɡʲɛl.kaˈmʲ.i
singielkę	sinˈɡʲɛl.kɛ
singielki	ˈsin.ɡʲɛlˈkʲ.i
singielko	sinˈɡʲɛl.kɔ
singielkom	sinˈɡʲɛl.kɔm
singielstw	ˈsin.ɡʲɛlstf
singielstwa	sinˈɡʲɛl.stfa
singielstwach	sinˈɡʲɛl.stfax
singielstwami	sinˈɡʲɛl.stfaˈmʲ.i
singielstwem	sinˈɡʲɛl.stfɛm
singielstwie	sinˈɡʲɛl.stfʲɛ
singielstwo	sinˈɡʲɛl.stfɔ
singielstwom	sinˈɡʲɛl.stfɔm
singielstwu	sinˈɡʲɛl.stfu
singla	ˈsin.ɡla
singlach	ˈsin.ɡlax
singlami	ˈsin.ɡlaˈmʲ.i
single	ˈsin.ɡlɛ
singlem	ˈsin.ɡlɛm
singli	sinkˈlʲ.i
singlom	ˈsin.ɡlɔm
singlów	ˈsin.ɡluf
singlowi	ˈsin.ɡlɔˈvʲ.i
singlu	ˈsin.ɡlu
sinusoid	siˈnu.sɔjt
sinusoida	si.nuˈsɔj.da
sinusoidą	si.nuˈsɔj.dɔ̃
sinusoidach	si.nuˈsɔj.dax
sinusoidalna	si.nu.sɔjˈdal.na
sinusoidalną	si.nu.sɔjˈdal.nɔ̃
sinusoidalne	si.nu.sɔjˈdal.nɛ
sinusoidalnego	si.nu.sɔj.dalˈnɛ.ɡɔ
sinusoidalnej	si.nu.sɔjˈdal.nɛj
sinusoidalnemu	si.nu.sɔj.dalˈnɛ.mu
sinusoidalni	si.nuˈsɔj.dalˈɲ.i
sinusoidalnie	si.nu.sɔjˈdal.ɲɛ
sinusoidalny	si.nu.sɔjˈdal.nɨ
sinusoidalnych	si.nu.sɔjˈdal.nɨx
sinusoidalnym	si.nu.sɔjˈdal.nɨm
sinusoidalnymi	si.nu.sɔjˈdal.nɨˈmʲ.i
sinusoidami	si.nuˈsɔj.daˈmʲ.i
sinusoidę	si.nuˈsɔj.dɛ
sinusoido	si.nuˈsɔj.dɔ
sinusoidom	si.nuˈsɔj.dɔm
sinusoidy	si.nuˈsɔj.dɨ
sinusoidzie	si.nuˈsɔj.d͡ʑɛ
Skirmuntt	ˈskʲir.munt
Smollet	ˈsmɔ.lɛt
Smolleta	smɔˈlɛ.ta
Smolletowi	smɔ.lɛˈtɔ.vʲi
Smolletowi	smɔˈlɛ.tɔˈvʲ.i
speed	spʲit
speeda	ˈspʲi.da
speedach	ˈspʲi.dax
speedami	ˈspʲi.daˈmʲ.i
speedem	ˈspʲi.dɛm
speedom	ˈspʲi.dɔm
speedów	ˈspʲi.duf
speedowi	ˈspʲi.dɔˈvʲ.i
speedy	ˈspʲi.dɨ
speedzie	ˈspʲi.d͡ʑɛ
Spencera	spɛnˈsɛ.ra
spleen	splʲin
Sprague	sprat͡ʂ
Stendhal	ˈstɛn.dal
Stern	ʂtɛrn
Stevenson	stiˈvɛn.sɔn
Strasburga	strazˈbur.ɡa
Strauss	ʂtraws
Street	strʲit
sui	swi
Taillefer	ˈtɛ.jfɛr
Taillefera	tɛˈjfɛ.ra
Tair	tajr
Tanner	ˈta.nɛr
Tartufa	tarˈti.fa
Tartufe	ˈtar.tif
tarzan	ˈtar.zan
tarzana	tarˈza.na
tarzanach	tarˈza.nax
tarzanami	tarˈza.naˈmʲ.i
tarzanem	tarˈza.nɛm
tarzanie	tarˈza.ɲɛ
tarzanom	tarˈza.nɔm
tarzanów	tarˈza.nuf
tarzanowi	tarˈza.nɔˈvʲ.i
tarzany	tarˈza.nɨ
Taylorem	tajˈlɔ.rɛm
team	tim
teamach	ˈti.max
teamami	ˈti.maˈmʲ.i
teamem	ˈti.mɛm
teamie	ˈti.mʲɛ
teamom	ˈti.mɔm
teamów	ˈti.muf
teamowi	ˈti.mɔˈvʲ.i
teamu	ˈti.mu
teamy	ˈti.mɨ
Teshoo	ˈtɛs.xɔ
Teuf'l	tajfl
Thatcher	ˈta.t͡ʂɛr
Thatcherowi	ta.t͡ʂɛˈrɔ.vʲi
Thatcherowi	taˈt͡ʂɛ.rɔˈvʲ.i
Thurm	turm
Tiecka	tiˈjɛ.ka
Tiery'ego	ti.jɛˈrɛ.ɡɔ
Tillet	ˈti.lɛ
Tilleta	tiˈlɛ.ta
Tilletem	tiˈlɛ.tɛm
TMT	tiˈɛm.ti
toast	tɔst
toasty	ˈtɔ.stɨ
Toby	ˈtɔ.bʲi
Toby	tɔˈbʲ.i
Toby'ego	tɔˈbʲɛ.ɡɔ
Tours	tur
Traugutt	ˈtraw.ɡut
Trelawney	ˈtrɛ.laˈɲ.i
Trelawney	trɛˈla.ɲi
Trelawney'a	trɛ.laˈnɛ.ja
Tuilerii	ˈtu.lɛˈrʲ.i
Tuilerii	tuˈlɛ.rʲi
Turcarecie	tur.kaˈrɛ.t͡ɕɛ
Turmhauser	turˈmxaw.zɛr
Turmhausera	tur.mxawˈzɛ.ra
Twain	twɛjn
umarzł	ˈu.marzw
umarzła	uˈmar.zwa
umarzli	ˈu.marsˈlʲ.i
umarzło	uˈmar.zwɔ
umarzłszy	uˈmar.zwʂɨ
umarzły	uˈmar.zwɨ
umarzną	uˈmar.znɔ̃
umarznąć	uˈmar.znɔɲt͡ɕ
umarznę	uˈmar.znɛ
umarznie	uˈmar.zɲɛ
umarznięci	uˈmar.zɲɛˈt͡ɕ.i
umarznięcia	u.marˈzɲɛɲ.t͡ɕa
umarzniecie	u.marˈzɲɛ.t͡ɕɛ
umarznięcie	u.marˈzɲɛɲ.t͡ɕɛ
umarznięciem	u.marˈzɲɛɲ.t͡ɕɛm
umarznięciu	u.marˈzɲɛɲ.t͡ɕu
umarzniemy	u.marˈzɲɛ.mɨ
umarzniesz	uˈmar.zɲɛʂ
umarznięta	u.marˈzɲɛn.ta
umarzniętą	u.marˈzɲɛn.tɔ̃
umarznięte	u.marˈzɲɛn.tɛ
umarzniętego	u.mar.zɲɛnˈtɛ.ɡɔ
umarzniętej	u.marˈzɲɛn.tɛj
umarzniętemu	u.mar.zɲɛnˈtɛ.mu
umarznięto	u.marˈzɲɛn.tɔ
umarznięty	u.marˈzɲɛn.tɨ
umarzniętych	u.marˈzɲɛn.tɨx
umarzniętym	u.marˈzɲɛn.tɨm
umarzniętymi	u.marˈzɲɛn.tɨˈmʲ.i
umarznij	uˈmar.zɲij
umarznijcie	u.marˈzɲij.t͡ɕɛ
umarznijmy	u.marˈzɲij.mɨ
Umballi	ˈum.baˈlʲ.i
Umballi	umˈba.lʲi
vae	vɛ
Valliere	ˈva.lʲɛr
Vandenesse	vanˈdɛ.nɛs
varietur	vaˈrʲɛ.tur
Vauquer	ˈvɔ.kɛ
vel	fɛl
Verdi	ˈvɛr.di
Verlaine	ˈvɛr.lɛn
Very'ego	vɛˈrʲɛ.ɡɔ
Very'ego	vɛrʲˈjɛ.ɡɔ
victis	ˈvʲik.tis
Vincent	ˈvʲin.sɛ
Vincent	ˈvʲin.sɛnt
vinum	ˈvʲi.num
vis-à-vis	ˈvʲi.zaˈvʲ.i
Voswinkel	vɔsˈfʲin.kɛl
Walter	ˈwal.tɛr
Ward	wart
Waterloo	vaˈtɛr.lɔ
Waterloo	waˈtɛr.lu
water-sky	wɔˈtɛr.skaj
web	wɛp
webach	ˈwɛ.bax
webami	ˈwɛ.baˈmʲ.i
webem	ˈwɛ.bɛm
webie	ˈwɛ.bʲɛ
webom	ˈwɛ.bɔm
webów	ˈwɛ.buf
webowi	ˈwɛ.bɔˈvʲ.i
webu	ˈwɛ.bu
weby	ˈwɛ.bɨ
Werbrust	ˈvɛr.brast
Westminster	wɛˈstmʲin.stɛr
Westmünster	wɛˈstmʲin.stɛr
Willie	ˈwi.lʲi
Willie	wiˈlʲ.i
windows	ˈwin.dɔws
windowsa	winˈdɔw.sa
windowsach	winˈdɔw.sax
windowsami	winˈdɔw.saˈmʲ.i
windowsem	winˈdɔw.sɛm
windowsie	winˈdɔw.ɕɛ
windowsom	winˈdɔw.sɔm
windowsów	winˈdɔw.suf
windowsowa	win.dɔwˈsɔ.va
windowsową	win.dɔwˈsɔ.vɔ̃
windowsowe	win.dɔwˈsɔ.vɛ
windowsowego	win.dɔw.sɔˈvɛ.ɡɔ
windowsowej	win.dɔwˈsɔ.vɛj
windowsowemu	win.dɔw.sɔˈvɛ.mu
windowsowi	winˈdɔw.sɔˈvʲ.i
windowsowy	win.dɔwˈsɔ.vɨ
windowsowych	win.dɔwˈsɔ.vɨx
windowsowym	win.dɔwˈsɔ.vɨm
windowsowymi	win.dɔwˈsɔ.vɨˈmʲ.i
windowsy	winˈdɔw.sɨ
windsurfer	winˈtsɛ.rfɛr
windsurfera	win.tsɛˈrfɛ.ra
windsurferach	win.tsɛˈrfɛ.rax
windsurferami	win.tsɛˈrfɛ.raˈmʲ.i
windsurferce	win.tsɛˈrfɛr.t͡sɛ
windsurferek	win.tsɛˈrfɛ.rɛk
windsurferem	win.tsɛˈrfɛ.rɛm
windsurferka	win.tsɛˈrfɛr.ka
windsurferką	win.tsɛˈrfɛr.kɔ̃
windsurferkach	win.tsɛˈrfɛr.kax
windsurferkami	win.tsɛˈrfɛr.kaˈmʲ.i
windsurferkę	win.tsɛˈrfɛr.kɛ
windsurferki	winˈtsɛ.rfɛrˈkʲ.i
windsurferko	win.tsɛˈrfɛr.kɔ
windsurferkom	win.tsɛˈrfɛr.kɔm
windsurferom	win.tsɛˈrfɛ.rɔm
windsurferów	win.tsɛˈrfɛ.ruf
windsurferowi	win.tsɛˈrfɛ.rɔˈvʲ.i
windsurfery	win.tsɛˈrfɛ.rɨ
windsurferze	win.tsɛˈrfɛ.ʐɛ
windsurferzy	win.tsɛˈrfɛ.ʐɨ
windsurfing	winˈtsɛr.fʲink
windsurfingach	win.tsɛrˈfʲin.ɡax
windsurfingami	win.tsɛrˈfʲin.ɡaˈmʲ.i
windsurfingi	winˈtsɛr.fʲinˈɡʲ.i
windsurfingiem	win.tsɛrˈfʲin.ɡʲɛm
windsurfingom	win.tsɛrˈfʲin.ɡɔm
windsurfingów	win.tsɛrˈfʲin.ɡuf
windsurfingowa	win.tsɛr.fʲinˈɡɔ.va
windsurfingową	win.tsɛr.fʲinˈɡɔ.vɔ̃
windsurfingowca	win.tsɛr.fʲinˈɡɔf.t͡sa
windsurfingowcach	win.tsɛr.fʲinˈɡɔf.t͡sax
windsurfingowcami	win.tsɛr.fʲinˈɡɔf.t͡saˈmʲ.i
windsurfingowce	win.tsɛr.fʲinˈɡɔf.t͡sɛ
windsurfingowcem	win.tsɛr.fʲinˈɡɔf.t͡sɛm
windsurfingowcom	win.tsɛr.fʲinˈɡɔf.t͡sɔm
windsurfingowców	win.tsɛr.fʲinˈɡɔf.t͡suf
windsurfingowcowi	win.tsɛr.fʲinˈɡɔf.t͡sɔˈvʲ.i
windsurfingowcu	win.tsɛr.fʲinˈɡɔf.t͡su
windsurfingowcy	win.tsɛr.fʲinˈɡɔf.t͡sɨ
windsurfingowcze	win.tsɛr.fʲinˈɡɔf.t͡ʂɛ
windsurfingowe	win.tsɛr.fʲinˈɡɔ.vɛ
windsurfingowego	win.tsɛr.fʲin.ɡɔˈvɛ.ɡɔ
windsurfingowej	win.tsɛr.fʲinˈɡɔ.vɛj
windsurfingowemu	win.tsɛr.fʲin.ɡɔˈvɛ.mu
windsurfingowi	win.tsɛrˈfʲin.ɡɔˈvʲ.i
windsurfingowiec	win.tsɛr.fʲinˈɡɔ.vʲɛt͡s
windsurfingowo	win.tsɛr.fʲinˈɡɔ.vɔ
windsurfingowy	win.tsɛr.fʲinˈɡɔ.vɨ
windsurfingowych	win.tsɛr.fʲinˈɡɔ.vɨx
windsurfingowym	win.tsɛr.fʲinˈɡɔ.vɨm
windsurfingowymi	win.tsɛr.fʲinˈɡɔ.vɨˈmʲ.i
windsurfingu	win.tsɛrˈfʲin.ɡu
wmarzł	vmarzw
wmarzła	ˈvmar.zwa
wmarzli	vmarsˈlʲ.i
wmarzło	ˈvmar.zwɔ
wmarzłszy	ˈvmar.zwʂɨ
wmarzły	ˈvmar.zwɨ
wmarzną	ˈvmar.znɔ̃
wmarznąć	ˈvmar.znɔɲt͡ɕ
wmarznę	ˈvmar.znɛ
wmarznie	ˈvmar.zɲɛ
wmarznięci	ˈvmar.zɲɛˈt͡ɕ.i
wmarznięcia	vmarˈzɲɛɲ.t͡ɕa
wmarzniecie	vmarˈzɲɛ.t͡ɕɛ
wmarznięcie	vmarˈzɲɛɲ.t͡ɕɛ
wmarznięciem	vmarˈzɲɛɲ.t͡ɕɛm
wmarznięciu	vmarˈzɲɛɲ.t͡ɕu
wmarzniemy	vmarˈzɲɛ.mɨ
wmarzniesz	ˈvmar.zɲɛʂ
wmarznięta	vmarˈzɲɛn.ta
wmarzniętą	vmarˈzɲɛn.tɔ̃
wmarznięte	vmarˈzɲɛn.tɛ
wmarzniętego	vmar.zɲɛnˈtɛ.ɡɔ
wmarzniętej	vmarˈzɲɛn.tɛj
wmarzniętemu	vmar.zɲɛnˈtɛ.mu
wmarznięto	vmarˈzɲɛn.tɔ
wmarznięty	vmarˈzɲɛn.tɨ
wmarzniętych	vmarˈzɲɛn.tɨx
wmarzniętym	vmarˈzɲɛn.tɨm
wmarzniętymi	vmarˈzɲɛn.tɨˈmʲ.i
wmarznij	ˈvmar.zɲij
wmarznijcie	vmarˈzɲij.t͡ɕɛ
wmarznijmy	vmarˈzɲij.mɨ
www	vuˈvu.vu
wymarzł	ˈvɨ.marzw
wymarzła	vɨˈmar.zwa
wymarzli	ˈvɨ.marsˈlʲ.i
wymarzło	vɨˈmar.zwɔ
wymarzłszy	vɨˈmar.zwʂɨ
wymarzły	vɨˈmar.zwɨ
wymarzną	vɨˈmar.znɔ̃
wymarznąć	vɨˈmar.znɔɲt͡ɕ
wymarznę	vɨˈmar.znɛ
wymarznie	vɨˈmar.zɲɛ
wymarznięci	vɨˈmar.zɲɛˈt͡ɕ.i
wymarznięcia	vɨ.marˈzɲɛɲ.t͡ɕa
wymarzniecie	vɨ.marˈzɲɛ.t͡ɕɛ
wymarznięcie	vɨ.marˈzɲɛɲ.t͡ɕɛ
wymarznięciem	vɨ.marˈzɲɛɲ.t͡ɕɛm
wymarznięciu	vɨ.marˈzɲɛɲ.t͡ɕu
wymarzniemy	vɨ.marˈzɲɛ.mɨ
wymarzniesz	vɨˈmar.zɲɛʂ
wymarznięta	vɨ.marˈzɲɛn.ta
wymarzniętą	vɨ.marˈzɲɛn.tɔ̃
wymarznięte	vɨ.marˈzɲɛn.tɛ
wymarzniętego	vɨ.mar.zɲɛnˈtɛ.ɡɔ
wymarzniętej	vɨ.marˈzɲɛn.tɛj
wymarzniętemu	vɨ.mar.zɲɛnˈtɛ.mu
wymarznięto	vɨ.marˈzɲɛn.tɔ
wymarznięty	vɨ.marˈzɲɛn.tɨ
wymarzniętych	vɨ.marˈzɲɛn.tɨx
wymarzniętym	vɨ.marˈzɲɛn.tɨm
wymarzniętymi	vɨ.marˈzɲɛn.tɨˈmʲ.i
wymarznij	vɨˈmar.zɲij
wymarznijcie	vɨ.marˈzɲij.t͡ɕɛ
wymarznijmy	vɨ.marˈzɲij.mɨ
youtube	ˈju.tup
youtube	juˈtʲj.up
youtube'a	ju.tʲjˈu.ba
youtube'a	juˈtu.ba
zamarza	zaˈmar.za
zamarzać	zaˈmar.zat͡ɕ
zamarzacie	za.marˈza.t͡ɕɛ
zamarzaj	zaˈmar.zaj
zamarzają	za.marˈza.jɔ̃
zamarzając	za.marˈza.jɔnt͡s
zamarzająca	za.mar.zaˈjɔn.t͡sa
zamarzającą	za.mar.zaˈjɔn.t͡sɔ̃
zamarzające	za.mar.zaˈjɔn.t͡sɛ
zamarzającego	za.mar.za.jɔnˈt͡sɛ.ɡɔ
zamarzającej	za.mar.zaˈjɔn.t͡sɛj
zamarzającemu	za.mar.za.jɔnˈt͡sɛ.mu
zamarzający	za.mar.zaˈjɔn.t͡sɨ
zamarzających	za.mar.zaˈjɔn.t͡sɨx
zamarzającym	za.mar.zaˈjɔn.t͡sɨm
zamarzającymi	za.mar.zaˈjɔn.t͡sɨˈmʲ.i
zamarzajcie	za.marˈzaj.t͡ɕɛ
zamarzajmy	za.marˈzaj.mɨ
zamarzał	zaˈmar.zaw
zamarzała	za.marˈza.wa
zamarzali	zaˈmar.zaˈlʲ.i
zamarzało	za.marˈza.wɔ
zamarzały	za.marˈza.wɨ
zamarzam	zaˈmar.zam
zamarzamy	za.marˈza.mɨ
zamarzana	za.marˈza.na
zamarzaną	za.marˈza.nɔ̃
zamarzane	za.marˈza.nɛ
zamarzanego	za.mar.zaˈnɛ.ɡɔ
zamarzanej	za.marˈza.nɛj
zamarzanemu	za.mar.zaˈnɛ.mu
zamarzani	zaˈmar.zaˈɲ.i
zamarzania	za.marˈza.ɲa
zamarzanie	za.marˈza.ɲɛ
zamarzaniem	za.marˈza.ɲɛm
zamarzaniu	za.marˈza.ɲu
zamarzano	za.marˈza.nɔ
zamarzany	za.marˈza.nɨ
zamarzanych	za.marˈza.nɨx
zamarzanym	za.marˈza.nɨm
zamarzanymi	za.marˈza.nɨˈmʲ.i
zamarzasz	zaˈmar.zaʂ
zamarzł	ˈza.marzw
zamarzła	zaˈmar.zwa
zamarzli	ˈza.marsˈlʲ.i
zamarzło	zaˈmar.zwɔ
zamarzłszy	zaˈmar.zwʂɨ
zamarzły	zaˈmar.zwɨ
zamarzną	zaˈmar.znɔ̃
zamarznąć	zaˈmar.znɔɲt͡ɕ
zamarznę	zaˈmar.znɛ
zamarznie	zaˈmar.zɲɛ
zamarznięci	zaˈmar.zɲɛˈt͡ɕ.i
zamarznięcia	za.marˈzɲɛɲ.t͡ɕa
zamarzniecie	za.marˈzɲɛ.t͡ɕɛ
zamarznięcie	za.marˈzɲɛɲ.t͡ɕɛ
zamarznięciem	za.marˈzɲɛɲ.t͡ɕɛm
zamarznięciu	za.marˈzɲɛɲ.t͡ɕu
zamarzniemy	za.marˈzɲɛ.mɨ
zamarzniesz	zaˈmar.zɲɛʂ
zamarznięta	za.marˈzɲɛn.ta
zamarzniętą	za.marˈzɲɛn.tɔ̃
zamarznięte	za.marˈzɲɛn.tɛ
zamarzniętego	za.mar.zɲɛnˈtɛ.ɡɔ
zamarzniętej	za.marˈzɲɛn.tɛj
zamarzniętemu	za.mar.zɲɛnˈtɛ.mu
zamarznięto	za.marˈzɲɛn.tɔ
zamarznięty	za.marˈzɲɛn.tɨ
zamarzniętych	za.marˈzɲɛn.tɨx
zamarzniętym	za.marˈzɲɛn.tɨm
zamarzniętymi	za.marˈzɲɛn.tɨˈmʲ.i
zamarznij	zaˈmar.zɲij
zamarznijcie	za.marˈzɲij.t͡ɕɛ
zamarznijmy	za.marˈzɲij.mɨ
żeglarsko-windsurfingowa	ʐɛɡ.lar.skɔ.win.tsɛr.fʲinˈɡɔ.va
żeglarsko-windsurfingową	ʐɛɡ.lar.skɔ.win.tsɛr.fʲinˈɡɔ.vɔ̃
żeglarsko-windsurfingowe	ʐɛɡ.lar.skɔ.win.tsɛr.fʲinˈɡɔ.vɛ
żeglarsko-windsurfingowego	ʐɛɡ.lar.skɔ.win.tsɛr.fʲin.ɡɔˈvɛ.ɡɔ
żeglarsko-windsurfingowej	ʐɛɡ.lar.skɔ.win.tsɛr.fʲinˈɡɔ.vɛj
żeglarsko-windsurfingowemu	ʐɛɡ.lar.skɔ.win.tsɛr.fʲin.ɡɔˈvɛ.mu
żeglarsko-windsurfingowi	ʐɛɡ.lar.skɔ.win.tsɛrˈfʲin.ɡɔˈvʲ.i
żeglarsko-windsurfingowy	ʐɛɡ.lar.skɔ.win.tsɛr.fʲinˈɡɔ.vɨ
żeglarsko-windsurfingowych	ʐɛɡ.lar.skɔ.win.tsɛr.fʲinˈɡɔ.vɨx
żeglarsko-windsurfingowym	ʐɛɡ.lar.skɔ.win.tsɛr.fʲinˈɡɔ.vɨm
żeglarsko-windsurfingowymi	ʐɛɡ.lar.skɔ.win.tsɛr.fʲinˈɡɔ.vɨˈmʲ.i
zmarzł	zmarzw
zmarzła	ˈzmar.zwa
zmarzli	zmarsˈlʲ.i
zmarzło	ˈzmar.zwɔ
zmarzłszy	ˈzmar.zwʂɨ
zmarzły	ˈzmar.zwɨ
zmarzną	ˈzmar.znɔ̃
zmarznąć	ˈzmar.znɔɲt͡ɕ
zmarznę	ˈzmar.znɛ
zmarznie	ˈzmar.zɲɛ
zmarznięci	ˈzmar.zɲɛˈt͡ɕ.i
zmarznięcia	zmarˈzɲɛɲ.t͡ɕa
zmarzniecie	zmarˈzɲɛ.t͡ɕɛ
zmarznięcie	zmarˈzɲɛɲ.t͡ɕɛ
zmarznięciem	zmarˈzɲɛɲ.t͡ɕɛm
zmarznięciu	zmarˈzɲɛɲ.t͡ɕu
zmarzniemy	zmarˈzɲɛ.mɨ
zmarzniesz	ˈzmar.zɲɛʂ
zmarznięta	zmarˈzɲɛn.ta
zmarzniętą	zmarˈzɲɛn.tɔ̃
zmarznięte	zmarˈzɲɛn.tɛ
zmarzniętego	zmar.zɲɛnˈtɛ.ɡɔ
zmarzniętej	zmarˈzɲɛn.tɛj
zmarzniętemu	zmar.zɲɛnˈtɛ.mu
zmarznięto	zmarˈzɲɛn.tɔ
zmarznięty	zmarˈzɲɛn.tɨ
zmarzniętych	zmarˈzɲɛn.tɨx
zmarzniętym	zmarˈzɲɛn.tɨm
zmarzniętymi	zmarˈzɲɛn.tɨˈmʲ.i
zmarznij	ˈzmar.zɲij
zmarznijcie	zmarˈzɲij.t͡ɕɛ
zmarznijmy	zmarˈzɲij.mɨ
zoomować	zuˈmɔ.vat͡ɕ
zoomował	zuˈmɔ.vaw
zoomowała	zu.mɔˈva.wa
zoomowałam	zu.mɔˈva.wam
zoomowałaś	zu.mɔˈva.waɕ
zoomowałem	zu.mɔˈva.wɛm
zoomowałeś	zu.mɔˈva.wɛɕ
zoomowali	zu.mɔˈva.lʲi
zoomowaliście	zu.mɔ.vaˈlʲiɕ.t͡ɕɛ
zoomowaliśmy	zu.mɔ.vaˈlʲiɕ.mɨ
zoomowało	zu.mɔˈva.wɔ
zoomowały	zu.mɔˈva.wɨ
zoomowałyście	zu.mɔ.vaˈwɨɕ.t͡ɕɛ
zoomowałyśmy	zu.mɔ.vaˈwɨɕ.mɨ
zoomowana	zu.mɔˈva.na
zoomowaną	zu.mɔˈva.nɔ̃
zoomowane	zu.mɔˈva.nɛ
zoomowanego	zu.mɔ.vaˈnɛ.ɡɔ
zoomowanej	zu.mɔˈva.nɛj
zoomowanemu	zu.mɔ.vaˈnɛ.mu
zoomowani	zu.mɔˈva.ɲi
zoomowania	zu.mɔˈva.ɲa
zoomowanie	zu.mɔˈva.ɲɛ
zoomowaniem	zu.mɔˈva.ɲɛm
zoomowaniu	zu.mɔˈva.ɲu
zoomowano	zu.mɔˈva.nɔ
zoomowany	zu.mɔˈva.nɨ
zoomowanych	zu.mɔˈva.nɨx
zoomowanym	zu.mɔˈva.nɨm
zoomowanymi	zu.mɔ.vaˈnɨ.mʲi
zoomuj	ˈzu.muj
zoomują	zuˈmu.jɔ̃
zoomując	zuˈmu.jɔnt͡s
zoomująca	zu.muˈjɔn.t͡sa
zoomującą	zu.muˈjɔn.t͡sɔ̃
zoomujące	zu.muˈjɔn.t͡sɛ
zoomującego	zu.mu.jɔnˈt͡sɛ.ɡɔ
zoomującej	zu.muˈjɔn.t͡sɛj
zoomującemu	zu.mu.jɔnˈt͡sɛ.mu
zoomujący	zu.muˈjɔn.t͡sɨ
zoomujących	zu.muˈjɔn.t͡sɨx
zoomującym	zu.muˈjɔn.t͡sɨm
zoomującymi	zu.mu.jɔnˈt͡sɨ.mʲi
zoomujcie	zuˈmuj.t͡ɕɛ
zoomuje	zuˈmu.jɛ
zoomuję	zuˈmu.jɛ
zoomujecie	zu.muˈjɛ.t͡ɕɛ
zoomujemy	zu.muˈjɛ.mɨ
zoomujesz	zuˈmu.jɛʂ
zoomujmy	zuˈmuj.mɨ
amazonka	a.maˈzɔn.ka
amazonką	a.maˈzɔn.kɔ̃
amazonkach	a.maˈzɔn.kax
amazonkami	a.maˈzɔn.kaˈmʲ.i
amazonkę	a.maˈzɔn.kɛ
amazonki	aˈma.zɔnˈkʲ.i
amazonko	a.maˈzɔn.kɔ
amazonkom	a.maˈzɔn.kɔm
